year_code,quarter_code,commercial_district_code,total_store_now,total_store_previous,store_count_diff
2022,1,3110001,42,41,1
2022,1,3110002,101,101,0
2022,1,3110003,136,129,7
2022,1,3110004,29,28,1
2022,1,3110005,86,86,0
2022,1,3110006,23,20,3
2022,1,3110007,73,70,3
2022,1,3110008,252,221,31
2022,1,3110009,105,100,5
2022,1,3110010,189,178,11
2022,1,3110012,632,610,22
2022,1,3110014,45,48,-3
2022,1,3110016,115,104,11
2022,1,3110017,53,50,3
2022,1,3110018,155,148,7
2022,1,3110020,114,105,9
2022,1,3110021,133,134,-1
2022,1,3110022,106,100,6
2022,1,3110023,46,43,3
2022,1,3110024,119,105,14
2022,1,3110025,63,61,2
2022,1,3110027,63,63,0
2022,1,3110028,214,204,10
2022,1,3110029,186,163,23
2022,1,3110030,37,38,-1
2022,1,3110031,63,60,3
2022,1,3110033,115,107,8
2022,1,3110035,158,149,9
2022,1,3110036,62,52,10
2022,1,3110037,120,114,6
2022,1,3110039,25,26,-1
2022,1,3110040,119,124,-5
2022,1,3110041,152,154,-2
2022,1,3110042,72,69,3
2022,1,3110043,222,213,9
2022,1,3110045,111,110,1
2022,1,3110047,62,48,14
2022,1,3110048,161,144,17
2022,1,3110049,159,151,8
2022,1,3110050,55,52,3
2022,1,3110051,77,69,8
2022,1,3110052,193,192,1
2022,1,3110053,228,212,16
2022,1,3110054,287,262,25
2022,1,3110055,110,110,0
2022,1,3110056,423,407,16
2022,1,3110057,157,148,9
2022,1,3110058,287,288,-1
2022,1,3110059,138,132,6
2022,1,3110060,178,170,8
2022,1,3110061,119,98,21
2022,1,3110062,251,226,25
2022,1,3110063,283,280,3
2022,1,3110064,189,182,7
2022,1,3110065,65,66,-1
2022,1,3110066,204,195,9
2022,1,3110067,204,193,11
2022,1,3110068,319,298,21
2022,1,3110069,499,496,3
2022,1,3110070,37,37,0
2022,1,3110071,81,79,2
2022,1,3110073,94,87,7
2022,1,3110074,229,212,17
2022,1,3110075,142,135,7
2022,1,3110077,86,78,8
2022,1,3110078,88,87,1
2022,1,3110079,382,359,23
2022,1,3110080,169,163,6
2022,1,3110081,249,232,17
2022,1,3110082,156,144,12
2022,1,3110083,86,78,8
2022,1,3110084,373,353,20
2022,1,3110085,350,316,34
2022,1,3110087,130,122,8
2022,1,3110088,93,90,3
2022,1,3110089,64,55,9
2022,1,3110090,128,124,4
2022,1,3110092,157,143,14
2022,1,3110093,401,383,18
2022,1,3110095,248,234,14
2022,1,3110096,67,69,-2
2022,1,3110098,76,68,8
2022,1,3110099,102,90,12
2022,1,3110102,171,163,8
2022,1,3110103,38,36,2
2022,1,3110104,106,95,11
2022,1,3110105,138,133,5
2022,1,3110107,50,49,1
2022,1,3110109,141,139,2
2022,1,3110110,107,101,6
2022,1,3110112,134,134,0
2022,1,3110113,62,51,11
2022,1,3110114,133,104,29
2022,1,3110115,204,197,7
2022,1,3110116,213,204,9
2022,1,3110117,86,84,2
2022,1,3110118,175,161,14
2022,1,3110120,110,93,17
2022,1,3110121,78,73,5
2022,1,3110122,219,211,8
2022,1,3110123,163,154,9
2022,1,3110124,191,176,15
2022,1,3110125,132,129,3
2022,1,3110126,31,27,4
2022,1,3110127,137,116,21
2022,1,3110128,533,497,36
2022,1,3110129,162,158,4
2022,1,3110130,47,47,0
2022,1,3110131,458,405,53
2022,1,3110132,130,119,11
2022,1,3110133,92,90,2
2022,1,3110134,339,319,20
2022,1,3110135,175,158,17
2022,1,3110136,456,393,63
2022,1,3110137,689,682,7
2022,1,3110138,170,164,6
2022,1,3110139,286,271,15
2022,1,3110140,382,369,13
2022,1,3110141,128,117,11
2022,1,3110142,275,255,20
2022,1,3110144,68,65,3
2022,1,3110146,200,206,-6
2022,1,3110147,245,232,13
2022,1,3110148,84,77,7
2022,1,3110149,53,49,4
2022,1,3110150,261,241,20
2022,1,3110151,255,236,19
2022,1,3110152,103,96,7
2022,1,3110153,66,59,7
2022,1,3110154,267,255,12
2022,1,3110155,170,155,15
2022,1,3110156,198,174,24
2022,1,3110157,245,229,16
2022,1,3110158,352,334,18
2022,1,3110159,454,449,5
2022,1,3110160,54,53,1
2022,1,3110161,306,300,6
2022,1,3110162,150,137,13
2022,1,3110163,201,195,6
2022,1,3110164,95,93,2
2022,1,3110165,178,175,3
2022,1,3110166,347,328,19
2022,1,3110167,315,296,19
2022,1,3110168,113,111,2
2022,1,3110169,137,131,6
2022,1,3110170,261,242,19
2022,1,3110171,37,35,2
2022,1,3110172,159,123,36
2022,1,3110173,91,88,3
2022,1,3110174,232,235,-3
2022,1,3110175,169,151,18
2022,1,3110176,228,215,13
2022,1,3110177,46,42,4
2022,1,3110178,60,59,1
2022,1,3110179,114,110,4
2022,1,3110180,231,224,7
2022,1,3110181,240,225,15
2022,1,3110182,105,105,0
2022,1,3110183,111,107,4
2022,1,3110184,44,40,4
2022,1,3110185,49,46,3
2022,1,3110186,59,59,0
2022,1,3110187,400,350,50
2022,1,3110188,231,220,11
2022,1,3110189,114,102,12
2022,1,3110190,112,100,12
2022,1,3110191,150,143,7
2022,1,3110193,90,89,1
2022,1,3110194,138,139,-1
2022,1,3110195,244,239,5
2022,1,3110197,34,31,3
2022,1,3110199,167,167,0
2022,1,3110200,42,41,1
2022,1,3110201,40,40,0
2022,1,3110203,83,79,4
2022,1,3110204,260,247,13
2022,1,3110205,256,247,9
2022,1,3110206,172,155,17
2022,1,3110207,80,78,2
2022,1,3110208,52,49,3
2022,1,3110209,63,64,-1
2022,1,3110210,160,148,12
2022,1,3110211,217,213,4
2022,1,3110212,229,231,-2
2022,1,3110213,37,38,-1
2022,1,3110214,107,102,5
2022,1,3110215,71,66,5
2022,1,3110216,149,138,11
2022,1,3110217,419,428,-9
2022,1,3110218,201,202,-1
2022,1,3110219,282,251,31
2022,1,3110220,355,347,8
2022,1,3110221,53,52,1
2022,1,3110224,84,84,0
2022,1,3110225,163,154,9
2022,1,3110226,789,751,38
2022,1,3110227,139,138,1
2022,1,3110228,336,322,14
2022,1,3110229,377,352,25
2022,1,3110230,176,170,6
2022,1,3110232,277,275,2
2022,1,3110233,155,148,7
2022,1,3110234,67,67,0
2022,1,3110236,344,317,27
2022,1,3110237,307,298,9
2022,1,3110238,44,37,7
2022,1,3110240,148,128,20
2022,1,3110241,318,287,31
2022,1,3110242,159,142,17
2022,1,3110243,290,281,9
2022,1,3110244,187,191,-4
2022,1,3110245,55,51,4
2022,1,3110246,214,174,40
2022,1,3110247,277,263,14
2022,1,3110248,51,47,4
2022,1,3110249,302,300,2
2022,1,3110250,75,70,5
2022,1,3110251,185,167,18
2022,1,3110252,229,216,13
2022,1,3110253,195,182,13
2022,1,3110254,352,325,27
2022,1,3110255,327,302,25
2022,1,3110256,309,288,21
2022,1,3110257,118,113,5
2022,1,3110258,207,177,30
2022,1,3110259,225,228,-3
2022,1,3110260,170,165,5
2022,1,3110261,182,172,10
2022,1,3110262,328,285,43
2022,1,3110263,207,192,15
2022,1,3110264,402,376,26
2022,1,3110265,141,139,2
2022,1,3110266,202,194,8
2022,1,3110267,220,218,2
2022,1,3110268,89,84,5
2022,1,3110269,86,78,8
2022,1,3110270,70,63,7
2022,1,3110271,34,37,-3
2022,1,3110272,405,395,10
2022,1,3110273,132,134,-2
2022,1,3110274,285,266,19
2022,1,3110275,91,89,2
2022,1,3110276,28,28,0
2022,1,3110277,198,184,14
2022,1,3110278,296,296,0
2022,1,3110280,41,35,6
2022,1,3110281,49,46,3
2022,1,3110282,64,62,2
2022,1,3110283,75,74,1
2022,1,3110284,46,47,-1
2022,1,3110285,92,88,4
2022,1,3110286,170,159,11
2022,1,3110287,50,46,4
2022,1,3110288,112,109,3
2022,1,3110289,127,112,15
2022,1,3110290,46,44,2
2022,1,3110291,229,221,8
2022,1,3110292,45,44,1
2022,1,3110293,198,183,15
2022,1,3110294,192,182,10
2022,1,3110295,174,170,4
2022,1,3110296,185,175,10
2022,1,3110297,236,221,15
2022,1,3110298,44,45,-1
2022,1,3110299,290,281,9
2022,1,3110300,310,298,12
2022,1,3110301,143,136,7
2022,1,3110302,174,166,8
2022,1,3110303,170,160,10
2022,1,3110304,136,121,15
2022,1,3110305,245,249,-4
2022,1,3110306,93,87,6
2022,1,3110307,146,147,-1
2022,1,3110308,190,185,5
2022,1,3110309,98,94,4
2022,1,3110310,23,21,2
2022,1,3110312,151,144,7
2022,1,3110313,316,316,0
2022,1,3110314,262,255,7
2022,1,3110315,217,214,3
2022,1,3110316,372,359,13
2022,1,3110317,131,117,14
2022,1,3110318,86,75,11
2022,1,3110319,233,232,1
2022,1,3110320,54,53,1
2022,1,3110322,83,78,5
2022,1,3110323,178,170,8
2022,1,3110325,147,137,10
2022,1,3110326,36,35,1
2022,1,3110327,155,147,8
2022,1,3110328,88,78,10
2022,1,3110329,98,92,6
2022,1,3110330,122,114,8
2022,1,3110331,193,178,15
2022,1,3110332,67,63,4
2022,1,3110333,192,180,12
2022,1,3110334,138,132,6
2022,1,3110335,303,287,16
2022,1,3110336,67,65,2
2022,1,3110337,97,92,5
2022,1,3110340,55,53,2
2022,1,3110341,92,86,6
2022,1,3110342,58,52,6
2022,1,3110343,117,108,9
2022,1,3110344,23,25,-2
2022,1,3110345,135,130,5
2022,1,3110346,85,81,4
2022,1,3110348,152,140,12
2022,1,3110349,30,31,-1
2022,1,3110350,95,92,3
2022,1,3110351,115,103,12
2022,1,3110352,194,181,13
2022,1,3110353,118,120,-2
2022,1,3110354,74,72,2
2022,1,3110355,125,114,11
2022,1,3110356,109,99,10
2022,1,3110357,114,110,4
2022,1,3110358,151,132,19
2022,1,3110359,172,161,11
2022,1,3110360,217,209,8
2022,1,3110361,92,92,0
2022,1,3110362,203,181,22
2022,1,3110363,46,41,5
2022,1,3110364,188,175,13
2022,1,3110365,141,137,4
2022,1,3110366,123,114,9
2022,1,3110367,154,146,8
2022,1,3110368,157,148,9
2022,1,3110369,304,298,6
2022,1,3110370,168,153,15
2022,1,3110371,136,144,-8
2022,1,3110372,132,123,9
2022,1,3110373,180,160,20
2022,1,3110374,354,332,22
2022,1,3110375,73,69,4
2022,1,3110376,360,331,29
2022,1,3110377,98,94,4
2022,1,3110378,114,108,6
2022,1,3110379,47,45,2
2022,1,3110380,29,24,5
2022,1,3110381,53,58,-5
2022,1,3110382,61,60,1
2022,1,3110383,104,99,5
2022,1,3110387,178,164,14
2022,1,3110388,86,78,8
2022,1,3110389,70,66,4
2022,1,3110390,174,162,12
2022,1,3110391,125,122,3
2022,1,3110392,66,66,0
2022,1,3110393,57,55,2
2022,1,3110394,255,234,21
2022,1,3110395,116,115,1
2022,1,3110396,217,202,15
2022,1,3110397,396,384,12
2022,1,3110398,243,228,15
2022,1,3110399,273,251,22
2022,1,3110400,269,268,1
2022,1,3110401,62,64,-2
2022,1,3110402,179,176,3
2022,1,3110403,345,342,3
2022,1,3110404,436,421,15
2022,1,3110405,419,417,2
2022,1,3110406,133,131,2
2022,1,3110407,341,337,4
2022,1,3110408,109,109,0
2022,1,3110409,262,260,2
2022,1,3110410,280,257,23
2022,1,3110411,121,117,4
2022,1,3110412,23,19,4
2022,1,3110413,81,73,8
2022,1,3110415,495,498,-3
2022,1,3110416,185,173,12
2022,1,3110417,42,44,-2
2022,1,3110418,69,73,-4
2022,1,3110419,368,354,14
2022,1,3110420,163,161,2
2022,1,3110421,226,228,-2
2022,1,3110422,105,107,-2
2022,1,3110423,142,138,4
2022,1,3110424,258,246,12
2022,1,3110425,263,245,18
2022,1,3110426,260,242,18
2022,1,3110427,45,42,3
2022,1,3110428,445,419,26
2022,1,3110429,434,425,9
2022,1,3110431,370,361,9
2022,1,3110432,133,126,7
2022,1,3110433,212,197,15
2022,1,3110434,100,96,4
2022,1,3110435,85,85,0
2022,1,3110436,77,74,3
2022,1,3110437,136,137,-1
2022,1,3110438,338,337,1
2022,1,3110439,136,134,2
2022,1,3110440,74,49,25
2022,1,3110441,171,167,4
2022,1,3110442,49,49,0
2022,1,3110443,50,47,3
2022,1,3110444,20,20,0
2022,1,3110446,69,69,0
2022,1,3110447,42,40,2
2022,1,3110448,81,73,8
2022,1,3110449,223,213,10
2022,1,3110450,367,346,21
2022,1,3110451,255,241,14
2022,1,3110452,186,183,3
2022,1,3110453,310,286,24
2022,1,3110454,143,141,2
2022,1,3110455,301,276,25
2022,1,3110456,347,309,38
2022,1,3110457,128,122,6
2022,1,3110458,239,221,18
2022,1,3110459,240,240,0
2022,1,3110460,322,306,16
2022,1,3110461,70,63,7
2022,1,3110462,161,154,7
2022,1,3110463,102,100,2
2022,1,3110464,199,190,9
2022,1,3110465,226,213,13
2022,1,3110466,142,136,6
2022,1,3110467,192,190,2
2022,1,3110468,459,428,31
2022,1,3110469,445,431,14
2022,1,3110470,114,112,2
2022,1,3110471,214,197,17
2022,1,3110472,293,277,16
2022,1,3110473,355,316,39
2022,1,3110474,138,125,13
2022,1,3110475,128,122,6
2022,1,3110476,61,56,5
2022,1,3110477,232,226,6
2022,1,3110478,151,142,9
2022,1,3110479,180,173,7
2022,1,3110480,101,95,6
2022,1,3110481,294,262,32
2022,1,3110482,52,55,-3
2022,1,3110483,69,61,8
2022,1,3110484,188,168,20
2022,1,3110485,128,127,1
2022,1,3110486,199,184,15
2022,1,3110487,70,73,-3
2022,1,3110488,181,167,14
2022,1,3110489,73,69,4
2022,1,3110490,119,115,4
2022,1,3110491,40,36,4
2022,1,3110493,82,77,5
2022,1,3110495,258,244,14
2022,1,3110496,220,215,5
2022,1,3110498,121,112,9
2022,1,3110499,143,129,14
2022,1,3110500,52,50,2
2022,1,3110501,62,61,1
2022,1,3110502,286,276,10
2022,1,3110503,341,321,20
2022,1,3110505,19,20,-1
2022,1,3110506,44,35,9
2022,1,3110507,438,423,15
2022,1,3110508,132,112,20
2022,1,3110509,369,252,117
2022,1,3110510,80,81,-1
2022,1,3110511,136,124,12
2022,1,3110512,102,93,9
2022,1,3110513,105,97,8
2022,1,3110514,53,49,4
2022,1,3110515,52,46,6
2022,1,3110517,73,75,-2
2022,1,3110519,106,104,2
2022,1,3110520,94,89,5
2022,1,3110521,83,77,6
2022,1,3110522,52,48,4
2022,1,3110523,22,21,1
2022,1,3110524,51,47,4
2022,1,3110525,143,141,2
2022,1,3110526,38,38,0
2022,1,3110527,130,122,8
2022,1,3110528,117,108,9
2022,1,3110529,215,210,5
2022,1,3110532,123,126,-3
2022,1,3110533,24,23,1
2022,1,3110534,52,49,3
2022,1,3110535,58,58,0
2022,1,3110536,42,40,2
2022,1,3110537,160,157,3
2022,1,3110538,73,66,7
2022,1,3110539,91,90,1
2022,1,3110540,88,78,10
2022,1,3110541,283,263,20
2022,1,3110542,306,276,30
2022,1,3110543,30,27,3
2022,1,3110544,1080,922,158
2022,1,3110545,268,238,30
2022,1,3110546,87,71,16
2022,1,3110547,264,256,8
2022,1,3110548,171,169,2
2022,1,3110549,124,113,11
2022,1,3110550,415,388,27
2022,1,3110551,201,190,11
2022,1,3110552,137,130,7
2022,1,3110553,172,164,8
2022,1,3110554,266,252,14
2022,1,3110555,74,73,1
2022,1,3110557,292,280,12
2022,1,3110558,437,402,35
2022,1,3110559,457,419,38
2022,1,3110560,118,109,9
2022,1,3110561,169,149,20
2022,1,3110562,276,254,22
2022,1,3110563,57,51,6
2022,1,3110564,226,209,17
2022,1,3110565,88,83,5
2022,1,3110566,527,489,38
2022,1,3110567,86,92,-6
2022,1,3110568,85,76,9
2022,1,3110569,308,290,18
2022,1,3110570,72,68,4
2022,1,3110571,139,129,10
2022,1,3110572,263,266,-3
2022,1,3110573,32,30,2
2022,1,3110574,47,46,1
2022,1,3110575,68,66,2
2022,1,3110576,223,214,9
2022,1,3110577,127,121,6
2022,1,3110578,320,320,0
2022,1,3110579,77,71,6
2022,1,3110580,61,59,2
2022,1,3110582,170,160,10
2022,1,3110583,47,46,1
2022,1,3110584,69,65,4
2022,1,3110585,49,48,1
2022,1,3110586,344,344,0
2022,1,3110587,144,149,-5
2022,1,3110588,95,95,0
2022,1,3110589,40,32,8
2022,1,3110590,132,120,12
2022,1,3110591,93,89,4
2022,1,3110592,61,59,2
2022,1,3110593,248,242,6
2022,1,3110594,119,112,7
2022,1,3110595,287,283,4
2022,1,3110596,107,101,6
2022,1,3110597,250,240,10
2022,1,3110598,229,224,5
2022,1,3110599,195,192,3
2022,1,3110600,196,188,8
2022,1,3110601,286,272,14
2022,1,3110602,103,103,0
2022,1,3110603,82,81,1
2022,1,3110604,236,222,14
2022,1,3110605,98,79,19
2022,1,3110606,288,279,9
2022,1,3110607,63,56,7
2022,1,3110608,222,212,10
2022,1,3110609,59,49,10
2022,1,3110611,109,103,6
2022,1,3110612,287,261,26
2022,1,3110613,50,54,-4
2022,1,3110614,186,167,19
2022,1,3110615,144,139,5
2022,1,3110616,48,44,4
2022,1,3110617,92,88,4
2022,1,3110618,230,203,27
2022,1,3110619,86,79,7
2022,1,3110620,379,359,20
2022,1,3110621,74,66,8
2022,1,3110622,166,156,10
2022,1,3110624,58,48,10
2022,1,3110625,388,375,13
2022,1,3110626,186,164,22
2022,1,3110627,257,250,7
2022,1,3110628,71,61,10
2022,1,3110629,25,22,3
2022,1,3110630,262,251,11
2022,1,3110631,107,95,12
2022,1,3110632,157,143,14
2022,1,3110633,90,95,-5
2022,1,3110634,455,428,27
2022,1,3110635,142,138,4
2022,1,3110636,105,107,-2
2022,1,3110637,119,116,3
2022,1,3110638,434,430,4
2022,1,3110639,109,98,11
2022,1,3110640,170,167,3
2022,1,3110641,103,93,10
2022,1,3110643,209,189,20
2022,1,3110644,32,31,1
2022,1,3110645,370,345,25
2022,1,3110646,409,385,24
2022,1,3110647,389,372,17
2022,1,3110649,202,192,10
2022,1,3110650,77,74,3
2022,1,3110651,240,234,6
2022,1,3110652,145,131,14
2022,1,3110653,186,177,9
2022,1,3110654,531,506,25
2022,1,3110655,175,179,-4
2022,1,3110656,509,473,36
2022,1,3110657,387,368,19
2022,1,3110658,156,149,7
2022,1,3110659,517,470,47
2022,1,3110660,561,554,7
2022,1,3110661,48,48,0
2022,1,3110662,349,336,13
2022,1,3110663,102,99,3
2022,1,3110664,74,69,5
2022,1,3110665,313,291,22
2022,1,3110666,43,35,8
2022,1,3110668,342,327,15
2022,1,3110670,163,147,16
2022,1,3110671,413,387,26
2022,1,3110672,74,60,14
2022,1,3110673,243,220,23
2022,1,3110675,194,178,16
2022,1,3110676,86,78,8
2022,1,3110677,70,63,7
2022,1,3110678,61,58,3
2022,1,3110679,63,63,0
2022,1,3110680,82,82,0
2022,1,3110681,32,31,1
2022,1,3110683,27,27,0
2022,1,3110684,82,75,7
2022,1,3110686,185,182,3
2022,1,3110687,38,38,0
2022,1,3110688,93,90,3
2022,1,3110689,157,141,16
2022,1,3110690,381,366,15
2022,1,3110691,171,161,10
2022,1,3110692,71,65,6
2022,1,3110693,21,21,0
2022,1,3110694,269,256,13
2022,1,3110695,303,294,9
2022,1,3110696,74,62,12
2022,1,3110697,95,85,10
2022,1,3110698,131,120,11
2022,1,3110699,130,124,6
2022,1,3110700,133,123,10
2022,1,3110701,116,113,3
2022,1,3110702,103,97,6
2022,1,3110703,216,211,5
2022,1,3110706,182,177,5
2022,1,3110707,142,137,5
2022,1,3110708,62,58,4
2022,1,3110709,125,117,8
2022,1,3110710,438,424,14
2022,1,3110711,282,259,23
2022,1,3110712,274,259,15
2022,1,3110713,520,501,19
2022,1,3110714,371,375,-4
2022,1,3110715,43,37,6
2022,1,3110716,165,158,7
2022,1,3110717,433,422,11
2022,1,3110718,271,256,15
2022,1,3110719,34,35,-1
2022,1,3110720,237,239,-2
2022,1,3110721,143,130,13
2022,1,3110722,135,104,31
2022,1,3110723,80,73,7
2022,1,3110724,108,102,6
2022,1,3110725,141,137,4
2022,1,3110726,97,90,7
2022,1,3110727,76,45,31
2022,1,3110728,78,73,5
2022,1,3110729,211,204,7
2022,1,3110730,205,196,9
2022,1,3110731,202,197,5
2022,1,3110732,224,214,10
2022,1,3110733,52,52,0
2022,1,3110734,21,16,5
2022,1,3110735,222,209,13
2022,1,3110736,237,231,6
2022,1,3110737,140,142,-2
2022,1,3110738,316,307,9
2022,1,3110739,21,21,0
2022,1,3110740,156,143,13
2022,1,3110741,200,196,4
2022,1,3110742,131,124,7
2022,1,3110743,219,209,10
2022,1,3110744,327,307,20
2022,1,3110745,167,166,1
2022,1,3110746,118,115,3
2022,1,3110747,93,87,6
2022,1,3110748,106,106,0
2022,1,3110749,207,202,5
2022,1,3110750,174,163,11
2022,1,3110751,157,146,11
2022,1,3110752,254,238,16
2022,1,3110753,241,236,5
2022,1,3110754,163,164,-1
2022,1,3110755,170,153,17
2022,1,3110756,119,107,12
2022,1,3110757,245,238,7
2022,1,3110758,42,42,0
2022,1,3110760,226,217,9
2022,1,3110762,641,630,11
2022,1,3110765,101,92,9
2022,1,3110766,206,195,11
2022,1,3110767,19,16,3
2022,1,3110768,90,79,11
2022,1,3110769,82,75,7
2022,1,3110770,171,170,1
2022,1,3110771,50,40,10
2022,1,3110772,36,37,-1
2022,1,3110774,130,133,-3
2022,1,3110775,106,103,3
2022,1,3110776,157,160,-3
2022,1,3110777,67,66,1
2022,1,3110778,374,363,11
2022,1,3110780,83,69,14
2022,1,3110781,131,129,2
2022,1,3110782,75,72,3
2022,1,3110783,127,130,-3
2022,1,3110784,56,58,-2
2022,1,3110785,177,169,8
2022,1,3110786,77,68,9
2022,1,3110787,201,198,3
2022,1,3110788,44,43,1
2022,1,3110789,195,192,3
2022,1,3110790,182,182,0
2022,1,3110791,33,34,-1
2022,1,3110792,213,204,9
2022,1,3110794,175,146,29
2022,1,3110795,55,50,5
2022,1,3110796,45,36,9
2022,1,3110798,30,35,-5
2022,1,3110799,29,33,-4
2022,1,3110800,43,39,4
2022,1,3110802,113,116,-3
2022,1,3110803,169,159,10
2022,1,3110804,137,129,8
2022,1,3110805,50,50,0
2022,1,3110807,86,75,11
2022,1,3110809,71,68,3
2022,1,3110810,269,264,5
2022,1,3110811,93,83,10
2022,1,3110812,110,114,-4
2022,1,3110813,291,264,27
2022,1,3110814,186,185,1
2022,1,3110815,254,258,-4
2022,1,3110816,96,89,7
2022,1,3110817,43,39,4
2022,1,3110818,35,35,0
2022,1,3110819,295,268,27
2022,1,3110820,194,189,5
2022,1,3110821,163,143,20
2022,1,3110822,68,63,5
2022,1,3110823,105,97,8
2022,1,3110824,79,68,11
2022,1,3110825,232,203,29
2022,1,3110826,226,215,11
2022,1,3110827,134,134,0
2022,1,3110828,301,292,9
2022,1,3110829,75,84,-9
2022,1,3110830,94,87,7
2022,1,3110831,104,93,11
2022,1,3110832,127,126,1
2022,1,3110833,128,120,8
2022,1,3110835,77,75,2
2022,1,3110836,475,460,15
2022,1,3110837,240,234,6
2022,1,3110838,54,54,0
2022,1,3110839,210,210,0
2022,1,3110840,197,194,3
2022,1,3110841,48,47,1
2022,1,3110842,156,150,6
2022,1,3110843,87,77,10
2022,1,3110845,46,44,2
2022,1,3110846,384,361,23
2022,1,3110847,77,68,9
2022,1,3110848,183,176,7
2022,1,3110849,182,174,8
2022,1,3110850,480,447,33
2022,1,3110851,105,91,14
2022,1,3110852,119,110,9
2022,1,3110853,89,87,2
2022,1,3110854,68,60,8
2022,1,3110855,406,402,4
2022,1,3110856,234,218,16
2022,1,3110857,155,149,6
2022,1,3110858,86,78,8
2022,1,3110859,79,74,5
2022,1,3110860,116,106,10
2022,1,3110861,480,444,36
2022,1,3110862,94,91,3
2022,1,3110863,189,181,8
2022,1,3110864,124,105,19
2022,1,3110865,339,336,3
2022,1,3110866,145,128,17
2022,1,3110867,135,117,18
2022,1,3110868,144,136,8
2022,1,3110869,424,376,48
2022,1,3110871,161,160,1
2022,1,3110872,58,49,9
2022,1,3110873,282,265,17
2022,1,3110874,108,119,-11
2022,1,3110875,83,80,3
2022,1,3110876,137,127,10
2022,1,3110877,218,196,22
2022,1,3110878,41,38,3
2022,1,3110879,86,91,-5
2022,1,3110880,51,49,2
2022,1,3110881,644,636,8
2022,1,3110882,228,225,3
2022,1,3110883,257,242,15
2022,1,3110884,120,117,3
2022,1,3110885,201,192,9
2022,1,3110886,131,123,8
2022,1,3110887,47,40,7
2022,1,3110888,136,126,10
2022,1,3110889,67,58,9
2022,1,3110890,153,136,17
2022,1,3110891,136,129,7
2022,1,3110892,540,499,41
2022,1,3110893,25,24,1
2022,1,3110895,561,534,27
2022,1,3110896,122,113,9
2022,1,3110897,199,186,13
2022,1,3110899,75,67,8
2022,1,3110900,185,176,9
2022,1,3110901,134,128,6
2022,1,3110902,373,347,26
2022,1,3110903,220,216,4
2022,1,3110904,166,155,11
2022,1,3110905,98,91,7
2022,1,3110906,63,62,1
2022,1,3110907,296,284,12
2022,1,3110908,232,255,-23
2022,1,3110910,77,79,-2
2022,1,3110912,128,133,-5
2022,1,3110913,169,186,-17
2022,1,3110915,91,83,8
2022,1,3110916,169,164,5
2022,1,3110917,45,41,4
2022,1,3110918,122,114,8
2022,1,3110919,104,101,3
2022,1,3110921,57,54,3
2022,1,3110922,70,62,8
2022,1,3110924,85,82,3
2022,1,3110925,116,111,5
2022,1,3110926,145,135,10
2022,1,3110929,206,198,8
2022,1,3110930,94,92,2
2022,1,3110931,31,30,1
2022,1,3110932,55,55,0
2022,1,3110934,223,178,45
2022,1,3110935,75,71,4
2022,1,3110936,85,85,0
2022,1,3110939,616,586,30
2022,1,3110940,73,70,3
2022,1,3110942,451,436,15
2022,1,3110943,172,165,7
2022,1,3110945,18,18,0
2022,1,3110947,24,23,1
2022,1,3110949,148,133,15
2022,1,3110951,95,81,14
2022,1,3110952,41,33,8
2022,1,3110953,89,75,14
2022,1,3110954,39,43,-4
2022,1,3110955,435,401,34
2022,1,3110956,57,53,4
2022,1,3110957,353,250,103
2022,1,3110958,120,117,3
2022,1,3110959,31,32,-1
2022,1,3110961,167,153,14
2022,1,3110966,343,323,20
2022,1,3110967,125,125,0
2022,1,3110968,60,63,-3
2022,1,3110969,86,81,5
2022,1,3110970,62,55,7
2022,1,3110971,175,162,13
2022,1,3110972,59,52,7
2022,1,3110973,165,150,15
2022,1,3110974,69,58,11
2022,1,3110975,50,49,1
2022,1,3110976,180,170,10
2022,1,3110979,60,54,6
2022,1,3110980,106,99,7
2022,1,3110981,203,199,4
2022,1,3110982,89,78,11
2022,1,3110983,105,94,11
2022,1,3110984,306,295,11
2022,1,3110988,58,54,4
2022,1,3110989,112,100,12
2022,1,3110992,381,344,37
2022,1,3110994,237,231,6
2022,1,3110995,102,98,4
2022,1,3110996,109,108,1
2022,1,3110997,624,595,29
2022,1,3110999,105,94,11
2022,1,3111001,61,53,8
2022,1,3111003,571,536,35
2022,1,3111004,666,631,35
2022,1,3111005,316,287,29
2022,1,3111006,476,434,42
2022,1,3111007,258,231,27
2022,1,3111008,236,223,13
2022,1,3111009,98,96,2
2022,1,3111010,442,404,38
2022,1,3111011,105,100,5
2022,1,3111012,280,252,28
2022,1,3111013,581,553,28
2022,1,3111014,162,157,5
2022,1,3111015,426,399,27
2022,1,3111016,172,167,5
2022,1,3111017,73,64,9
2022,1,3111019,321,294,27
2022,1,3111020,139,133,6
2022,1,3111021,693,670,23
2022,1,3111022,98,94,4
2022,1,3111023,153,144,9
2022,1,3111024,79,74,5
2022,1,3111025,126,124,2
2022,1,3111026,292,268,24
2022,1,3111027,317,299,18
2022,1,3111028,164,160,4
2022,1,3111029,92,91,1
2022,1,3111030,186,178,8
2022,1,3111031,152,143,9
2022,1,3111032,199,197,2
2022,1,3111033,62,62,0
2022,1,3111034,234,215,19
2022,1,3111035,135,125,10
2022,1,3111036,62,60,2
2022,1,3111037,44,45,-1
2022,1,3111038,163,157,6
2022,1,3111039,143,138,5
2022,1,3111040,63,60,3
2022,1,3111042,288,270,18
2022,1,3111043,61,52,9
2022,1,3111044,282,268,14
2022,1,3111045,44,40,4
2022,1,3111046,500,491,9
2022,1,3111047,79,69,10
2022,1,3111049,221,194,27
2022,1,3111051,313,295,18
2022,1,3111052,297,273,24
2022,1,3111053,252,227,25
2022,1,3111054,49,49,0
2022,1,3111055,30,28,2
2022,1,3111056,92,62,30
2022,1,3111057,231,228,3
2022,1,3111058,86,81,5
2022,1,3111059,627,569,58
2022,1,3111060,531,514,17
2022,1,3111061,364,342,22
2022,1,3111062,169,166,3
2022,1,3111063,220,201,19
2022,1,3111064,140,137,3
2022,1,3111065,72,67,5
2022,1,3111066,217,201,16
2022,1,3111067,346,316,30
2022,1,3111068,38,36,2
2022,1,3111069,134,123,11
2022,1,3111070,80,73,7
2022,1,3111071,51,51,0
2022,1,3111072,233,214,19
2022,1,3111073,363,354,9
2022,1,3111074,107,101,6
2022,1,3111075,141,125,16
2022,1,3111076,158,169,-11
2022,1,3111077,568,550,18
2022,1,3111078,554,525,29
2022,1,3111079,90,78,12
2022,1,3111080,203,197,6
2022,1,3111082,27,24,3
2022,1,3111083,183,176,7
2022,1,3111084,40,44,-4
2022,1,3111085,277,268,9
2022,1,3111086,219,210,9
2022,1,3111087,106,94,12
2022,1,3111088,168,161,7
2022,1,3111089,424,419,5
2022,2,3110001,41,45,-4
2022,2,3110002,100,101,-1
2022,2,3110003,135,134,1
2022,2,3110004,30,28,2
2022,2,3110005,87,87,0
2022,2,3110006,26,21,5
2022,2,3110007,74,72,2
2022,2,3110008,250,227,23
2022,2,3110009,106,100,6
2022,2,3110010,189,179,10
2022,2,3110012,632,618,14
2022,2,3110014,46,46,0
2022,2,3110016,115,108,7
2022,2,3110017,52,52,0
2022,2,3110018,155,150,5
2022,2,3110020,116,110,6
2022,2,3110021,133,133,0
2022,2,3110022,106,101,5
2022,2,3110023,46,44,2
2022,2,3110024,116,107,9
2022,2,3110025,62,62,0
2022,2,3110027,70,64,6
2022,2,3110028,215,203,12
2022,2,3110029,182,167,15
2022,2,3110030,36,37,-1
2022,2,3110031,63,63,0
2022,2,3110033,114,111,3
2022,2,3110035,158,155,3
2022,2,3110036,64,53,11
2022,2,3110037,120,116,4
2022,2,3110039,23,25,-2
2022,2,3110040,118,124,-6
2022,2,3110041,154,154,0
2022,2,3110042,69,71,-2
2022,2,3110043,218,217,1
2022,2,3110045,108,111,-3
2022,2,3110047,60,54,6
2022,2,3110048,160,149,11
2022,2,3110049,156,152,4
2022,2,3110050,53,54,-1
2022,2,3110051,76,69,7
2022,2,3110052,195,188,7
2022,2,3110053,228,216,12
2022,2,3110054,284,277,7
2022,2,3110055,109,109,0
2022,2,3110056,420,408,12
2022,2,3110057,155,153,2
2022,2,3110058,283,285,-2
2022,2,3110059,137,137,0
2022,2,3110060,178,175,3
2022,2,3110061,114,104,10
2022,2,3110062,256,233,23
2022,2,3110063,286,278,8
2022,2,3110064,187,184,3
2022,2,3110065,65,65,0
2022,2,3110066,203,194,9
2022,2,3110067,209,196,13
2022,2,3110068,323,310,13
2022,2,3110069,503,495,8
2022,2,3110070,38,38,0
2022,2,3110071,80,81,-1
2022,2,3110073,97,85,12
2022,2,3110074,228,212,16
2022,2,3110075,142,142,0
2022,2,3110077,86,81,5
2022,2,3110078,88,88,0
2022,2,3110079,383,364,19
2022,2,3110080,171,163,8
2022,2,3110081,256,236,20
2022,2,3110082,153,151,2
2022,2,3110083,86,78,8
2022,2,3110084,389,369,20
2022,2,3110085,359,331,28
2022,2,3110087,128,123,5
2022,2,3110088,91,91,0
2022,2,3110089,65,59,6
2022,2,3110090,126,122,4
2022,2,3110092,157,148,9
2022,2,3110093,401,390,11
2022,2,3110095,256,238,18
2022,2,3110096,71,71,0
2022,2,3110098,74,74,0
2022,2,3110099,103,95,8
2022,2,3110102,173,165,8
2022,2,3110103,38,37,1
2022,2,3110104,105,98,7
2022,2,3110105,137,135,2
2022,2,3110107,51,51,0
2022,2,3110109,142,142,0
2022,2,3110110,109,103,6
2022,2,3110112,135,135,0
2022,2,3110113,63,54,9
2022,2,3110114,132,103,29
2022,2,3110115,205,197,8
2022,2,3110116,214,216,-2
2022,2,3110117,87,83,4
2022,2,3110118,172,167,5
2022,2,3110120,117,100,17
2022,2,3110121,77,77,0
2022,2,3110122,217,213,4
2022,2,3110123,166,158,8
2022,2,3110124,195,179,16
2022,2,3110125,134,129,5
2022,2,3110126,31,29,2
2022,2,3110127,136,123,13
2022,2,3110128,535,512,23
2022,2,3110129,169,157,12
2022,2,3110130,47,49,-2
2022,2,3110131,461,427,34
2022,2,3110132,129,119,10
2022,2,3110133,90,90,0
2022,2,3110134,335,325,10
2022,2,3110135,173,169,4
2022,2,3110136,459,408,51
2022,2,3110137,696,686,10
2022,2,3110138,169,166,3
2022,2,3110139,294,274,20
2022,2,3110140,385,369,16
2022,2,3110141,130,121,9
2022,2,3110142,273,262,11
2022,2,3110144,67,67,0
2022,2,3110146,204,205,-1
2022,2,3110147,247,234,13
2022,2,3110148,82,81,1
2022,2,3110149,55,50,5
2022,2,3110150,262,250,12
2022,2,3110151,254,243,11
2022,2,3110152,102,96,6
2022,2,3110153,68,60,8
2022,2,3110154,267,259,8
2022,2,3110155,171,154,17
2022,2,3110156,198,184,14
2022,2,3110157,246,231,15
2022,2,3110158,346,343,3
2022,2,3110159,452,443,9
2022,2,3110160,54,55,-1
2022,2,3110161,311,304,7
2022,2,3110162,150,143,7
2022,2,3110163,204,201,3
2022,2,3110164,94,92,2
2022,2,3110165,178,177,1
2022,2,3110166,349,334,15
2022,2,3110167,312,303,9
2022,2,3110168,114,112,2
2022,2,3110169,137,134,3
2022,2,3110170,263,246,17
2022,2,3110171,37,35,2
2022,2,3110172,158,124,34
2022,2,3110173,91,91,0
2022,2,3110174,237,233,4
2022,2,3110175,165,161,4
2022,2,3110176,230,222,8
2022,2,3110177,46,44,2
2022,2,3110178,60,57,3
2022,2,3110179,115,112,3
2022,2,3110180,232,229,3
2022,2,3110181,240,226,14
2022,2,3110182,105,104,1
2022,2,3110183,111,107,4
2022,2,3110184,44,41,3
2022,2,3110185,49,47,2
2022,2,3110186,62,60,2
2022,2,3110187,394,352,42
2022,2,3110188,232,223,9
2022,2,3110189,112,106,6
2022,2,3110190,107,104,3
2022,2,3110191,152,149,3
2022,2,3110193,92,93,-1
2022,2,3110194,137,139,-2
2022,2,3110195,240,243,-3
2022,2,3110197,35,33,2
2022,2,3110199,168,171,-3
2022,2,3110200,45,42,3
2022,2,3110201,40,41,-1
2022,2,3110203,85,80,5
2022,2,3110204,262,253,9
2022,2,3110205,263,243,20
2022,2,3110206,175,163,12
2022,2,3110207,80,79,1
2022,2,3110208,51,49,2
2022,2,3110209,65,65,0
2022,2,3110210,162,149,13
2022,2,3110211,218,219,-1
2022,2,3110212,234,225,9
2022,2,3110213,39,39,0
2022,2,3110214,105,103,2
2022,2,3110215,71,69,2
2022,2,3110216,153,143,10
2022,2,3110217,417,427,-10
2022,2,3110218,199,198,1
2022,2,3110219,285,262,23
2022,2,3110220,357,346,11
2022,2,3110221,53,52,1
2022,2,3110224,85,81,4
2022,2,3110225,167,159,8
2022,2,3110226,789,766,23
2022,2,3110227,139,138,1
2022,2,3110228,339,332,7
2022,2,3110229,379,353,26
2022,2,3110230,181,174,7
2022,2,3110232,280,279,1
2022,2,3110233,156,152,4
2022,2,3110234,65,67,-2
2022,2,3110236,342,327,15
2022,2,3110237,308,301,7
2022,2,3110238,44,37,7
2022,2,3110240,148,133,15
2022,2,3110241,320,297,23
2022,2,3110242,158,143,15
2022,2,3110243,292,288,4
2022,2,3110244,189,190,-1
2022,2,3110245,58,52,6
2022,2,3110246,210,178,32
2022,2,3110247,283,274,9
2022,2,3110248,51,47,4
2022,2,3110249,303,301,2
2022,2,3110250,77,73,4
2022,2,3110251,183,177,6
2022,2,3110252,230,221,9
2022,2,3110253,198,185,13
2022,2,3110254,356,341,15
2022,2,3110255,331,314,17
2022,2,3110256,312,294,18
2022,2,3110257,117,118,-1
2022,2,3110258,208,184,24
2022,2,3110259,229,228,1
2022,2,3110260,170,167,3
2022,2,3110261,183,174,9
2022,2,3110262,324,291,33
2022,2,3110263,209,192,17
2022,2,3110264,400,384,16
2022,2,3110265,140,138,2
2022,2,3110266,203,193,10
2022,2,3110267,219,220,-1
2022,2,3110268,92,88,4
2022,2,3110269,85,78,7
2022,2,3110270,70,69,1
2022,2,3110271,35,35,0
2022,2,3110272,402,400,2
2022,2,3110273,137,135,2
2022,2,3110274,283,277,6
2022,2,3110275,95,88,7
2022,2,3110276,28,27,1
2022,2,3110277,201,191,10
2022,2,3110278,300,301,-1
2022,2,3110280,38,36,2
2022,2,3110281,50,49,1
2022,2,3110282,66,62,4
2022,2,3110283,75,74,1
2022,2,3110284,47,47,0
2022,2,3110285,95,91,4
2022,2,3110286,170,163,7
2022,2,3110287,50,46,4
2022,2,3110288,110,110,0
2022,2,3110289,129,118,11
2022,2,3110290,44,43,1
2022,2,3110291,234,227,7
2022,2,3110292,45,46,-1
2022,2,3110293,201,188,13
2022,2,3110294,193,185,8
2022,2,3110295,172,171,1
2022,2,3110296,186,180,6
2022,2,3110297,240,225,15
2022,2,3110298,45,44,1
2022,2,3110299,294,284,10
2022,2,3110300,312,301,11
2022,2,3110301,142,141,1
2022,2,3110302,176,170,6
2022,2,3110303,171,164,7
2022,2,3110304,140,127,13
2022,2,3110305,248,247,1
2022,2,3110306,91,89,2
2022,2,3110307,144,148,-4
2022,2,3110308,189,185,4
2022,2,3110309,98,91,7
2022,2,3110310,23,21,2
2022,2,3110312,156,152,4
2022,2,3110313,323,314,9
2022,2,3110314,260,260,0
2022,2,3110315,217,212,5
2022,2,3110316,377,362,15
2022,2,3110317,130,121,9
2022,2,3110318,87,81,6
2022,2,3110319,238,236,2
2022,2,3110320,54,53,1
2022,2,3110322,83,81,2
2022,2,3110323,180,176,4
2022,2,3110325,149,138,11
2022,2,3110326,36,35,1
2022,2,3110327,157,148,9
2022,2,3110328,89,80,9
2022,2,3110329,100,97,3
2022,2,3110330,118,118,0
2022,2,3110331,193,181,12
2022,2,3110332,66,65,1
2022,2,3110333,190,184,6
2022,2,3110334,138,134,4
2022,2,3110335,300,291,9
2022,2,3110336,66,65,1
2022,2,3110337,92,92,0
2022,2,3110340,55,53,2
2022,2,3110341,94,87,7
2022,2,3110342,59,55,4
2022,2,3110343,119,109,10
2022,2,3110344,22,26,-4
2022,2,3110345,135,130,5
2022,2,3110346,84,85,-1
2022,2,3110348,153,142,11
2022,2,3110349,30,32,-2
2022,2,3110350,95,96,-1
2022,2,3110351,113,108,5
2022,2,3110352,195,183,12
2022,2,3110353,119,119,0
2022,2,3110354,73,73,0
2022,2,3110355,125,116,9
2022,2,3110356,109,104,5
2022,2,3110357,115,112,3
2022,2,3110358,151,138,13
2022,2,3110359,172,164,8
2022,2,3110360,218,214,4
2022,2,3110361,89,91,-2
2022,2,3110362,202,188,14
2022,2,3110363,44,43,1
2022,2,3110364,187,176,11
2022,2,3110365,143,140,3
2022,2,3110366,124,119,5
2022,2,3110367,156,145,11
2022,2,3110368,156,151,5
2022,2,3110369,306,301,5
2022,2,3110370,169,157,12
2022,2,3110371,139,141,-2
2022,2,3110372,134,127,7
2022,2,3110373,183,171,12
2022,2,3110374,359,344,15
2022,2,3110375,75,73,2
2022,2,3110376,353,344,9
2022,2,3110377,97,93,4
2022,2,3110378,113,107,6
2022,2,3110379,46,45,1
2022,2,3110380,29,26,3
2022,2,3110381,53,58,-5
2022,2,3110382,62,59,3
2022,2,3110383,101,100,1
2022,2,3110387,180,170,10
2022,2,3110388,85,79,6
2022,2,3110389,70,69,1
2022,2,3110390,179,168,11
2022,2,3110391,122,121,1
2022,2,3110392,68,65,3
2022,2,3110393,57,59,-2
2022,2,3110394,254,243,11
2022,2,3110395,115,117,-2
2022,2,3110396,215,205,10
2022,2,3110397,395,384,11
2022,2,3110398,242,233,9
2022,2,3110399,276,257,19
2022,2,3110400,270,266,4
2022,2,3110401,60,63,-3
2022,2,3110402,182,179,3
2022,2,3110403,349,346,3
2022,2,3110404,436,418,18
2022,2,3110405,424,417,7
2022,2,3110406,135,131,4
2022,2,3110407,342,336,6
2022,2,3110408,109,110,-1
2022,2,3110409,263,262,1
2022,2,3110410,275,260,15
2022,2,3110411,122,117,5
2022,2,3110412,22,21,1
2022,2,3110413,83,80,3
2022,2,3110415,497,497,0
2022,2,3110416,181,177,4
2022,2,3110417,44,44,0
2022,2,3110418,69,72,-3
2022,2,3110419,364,357,7
2022,2,3110420,163,161,2
2022,2,3110421,226,223,3
2022,2,3110422,106,106,0
2022,2,3110423,146,136,10
2022,2,3110424,257,251,6
2022,2,3110425,263,252,11
2022,2,3110426,265,242,23
2022,2,3110427,46,46,0
2022,2,3110428,445,430,15
2022,2,3110429,434,427,7
2022,2,3110431,377,367,10
2022,2,3110432,132,126,6
2022,2,3110433,213,201,12
2022,2,3110434,100,97,3
2022,2,3110435,85,85,0
2022,2,3110436,78,73,5
2022,2,3110437,134,136,-2
2022,2,3110438,340,339,1
2022,2,3110439,137,137,0
2022,2,3110440,74,50,24
2022,2,3110441,173,170,3
2022,2,3110442,50,47,3
2022,2,3110443,50,47,3
2022,2,3110444,20,19,1
2022,2,3110446,69,68,1
2022,2,3110447,39,41,-2
2022,2,3110448,80,76,4
2022,2,3110449,221,217,4
2022,2,3110450,367,355,12
2022,2,3110451,254,244,10
2022,2,3110452,185,188,-3
2022,2,3110453,308,298,10
2022,2,3110454,144,144,0
2022,2,3110455,297,284,13
2022,2,3110456,348,321,27
2022,2,3110457,125,125,0
2022,2,3110458,240,231,9
2022,2,3110459,242,239,3
2022,2,3110460,322,307,15
2022,2,3110461,71,67,4
2022,2,3110462,161,158,3
2022,2,3110463,101,105,-4
2022,2,3110464,201,187,14
2022,2,3110465,228,215,13
2022,2,3110466,144,135,9
2022,2,3110467,194,197,-3
2022,2,3110468,467,438,29
2022,2,3110469,444,440,4
2022,2,3110470,114,111,3
2022,2,3110471,214,201,13
2022,2,3110472,292,280,12
2022,2,3110473,361,331,30
2022,2,3110474,141,130,11
2022,2,3110475,131,126,5
2022,2,3110476,62,57,5
2022,2,3110477,231,231,0
2022,2,3110478,151,143,8
2022,2,3110479,183,178,5
2022,2,3110480,101,96,5
2022,2,3110481,297,276,21
2022,2,3110482,50,56,-6
2022,2,3110483,68,63,5
2022,2,3110484,186,171,15
2022,2,3110485,130,126,4
2022,2,3110486,198,183,15
2022,2,3110487,69,72,-3
2022,2,3110488,183,172,11
2022,2,3110489,75,68,7
2022,2,3110490,119,116,3
2022,2,3110491,41,37,4
2022,2,3110493,81,80,1
2022,2,3110495,251,250,1
2022,2,3110496,222,216,6
2022,2,3110498,121,116,5
2022,2,3110499,140,136,4
2022,2,3110500,52,51,1
2022,2,3110501,61,62,-1
2022,2,3110502,288,274,14
2022,2,3110503,339,327,12
2022,2,3110505,18,19,-1
2022,2,3110506,44,37,7
2022,2,3110507,440,430,10
2022,2,3110508,133,123,10
2022,2,3110509,366,299,67
2022,2,3110510,78,79,-1
2022,2,3110511,135,126,9
2022,2,3110512,100,95,5
2022,2,3110513,106,99,7
2022,2,3110514,53,52,1
2022,2,3110515,53,52,1
2022,2,3110517,74,75,-1
2022,2,3110519,103,108,-5
2022,2,3110520,92,89,3
2022,2,3110521,80,76,4
2022,2,3110522,51,51,0
2022,2,3110523,19,22,-3
2022,2,3110524,52,50,2
2022,2,3110525,145,144,1
2022,2,3110526,37,38,-1
2022,2,3110527,134,125,9
2022,2,3110528,121,108,13
2022,2,3110529,220,212,8
2022,2,3110532,125,126,-1
2022,2,3110533,23,25,-2
2022,2,3110534,53,52,1
2022,2,3110535,63,58,5
2022,2,3110536,43,42,1
2022,2,3110537,159,156,3
2022,2,3110538,73,72,1
2022,2,3110539,90,90,0
2022,2,3110540,90,84,6
2022,2,3110541,284,263,21
2022,2,3110542,311,293,18
2022,2,3110543,31,27,4
2022,2,3110544,1096,955,141
2022,2,3110545,271,247,24
2022,2,3110546,89,76,13
2022,2,3110547,266,261,5
2022,2,3110548,175,168,7
2022,2,3110549,123,117,6
2022,2,3110550,421,397,24
2022,2,3110551,200,195,5
2022,2,3110552,140,131,9
2022,2,3110553,173,168,5
2022,2,3110554,262,256,6
2022,2,3110555,73,74,-1
2022,2,3110557,294,285,9
2022,2,3110558,433,413,20
2022,2,3110559,458,437,21
2022,2,3110560,119,110,9
2022,2,3110561,167,151,16
2022,2,3110562,277,270,7
2022,2,3110563,57,52,5
2022,2,3110564,231,215,16
2022,2,3110565,86,81,5
2022,2,3110566,546,504,42
2022,2,3110567,85,91,-6
2022,2,3110568,83,73,10
2022,2,3110569,313,296,17
2022,2,3110570,70,69,1
2022,2,3110571,136,130,6
2022,2,3110572,265,269,-4
2022,2,3110573,31,31,0
2022,2,3110574,48,46,2
2022,2,3110575,72,65,7
2022,2,3110576,231,221,10
2022,2,3110577,130,120,10
2022,2,3110578,319,323,-4
2022,2,3110579,78,72,6
2022,2,3110580,63,57,6
2022,2,3110582,170,164,6
2022,2,3110583,47,45,2
2022,2,3110584,70,66,4
2022,2,3110585,50,50,0
2022,2,3110586,345,338,7
2022,2,3110587,146,145,1
2022,2,3110588,93,97,-4
2022,2,3110589,38,37,1
2022,2,3110590,131,122,9
2022,2,3110591,92,88,4
2022,2,3110592,60,58,2
2022,2,3110593,251,246,5
2022,2,3110594,119,117,2
2022,2,3110595,282,282,0
2022,2,3110596,109,102,7
2022,2,3110597,250,243,7
2022,2,3110598,228,224,4
2022,2,3110599,198,190,8
2022,2,3110600,196,186,10
2022,2,3110601,282,277,5
2022,2,3110602,104,103,1
2022,2,3110603,84,82,2
2022,2,3110604,233,228,5
2022,2,3110605,101,83,18
2022,2,3110606,290,279,11
2022,2,3110607,64,56,8
2022,2,3110608,222,213,9
2022,2,3110609,57,54,3
2022,2,3110611,111,107,4
2022,2,3110612,290,269,21
2022,2,3110613,47,52,-5
2022,2,3110614,189,171,18
2022,2,3110615,141,142,-1
2022,2,3110616,47,46,1
2022,2,3110617,94,94,0
2022,2,3110618,229,209,20
2022,2,3110619,88,82,6
2022,2,3110620,384,366,18
2022,2,3110621,76,70,6
2022,2,3110622,165,160,5
2022,2,3110624,59,56,3
2022,2,3110625,392,381,11
2022,2,3110626,188,173,15
2022,2,3110627,258,249,9
2022,2,3110628,69,63,6
2022,2,3110629,27,24,3
2022,2,3110630,262,254,8
2022,2,3110631,103,99,4
2022,2,3110632,159,147,12
2022,2,3110633,95,93,2
2022,2,3110634,456,430,26
2022,2,3110635,147,135,12
2022,2,3110636,104,105,-1
2022,2,3110637,119,115,4
2022,2,3110638,445,434,11
2022,2,3110639,107,102,5
2022,2,3110640,170,167,3
2022,2,3110641,105,95,10
2022,2,3110643,206,199,7
2022,2,3110644,32,32,0
2022,2,3110645,374,354,20
2022,2,3110646,415,389,26
2022,2,3110647,394,376,18
2022,2,3110649,207,195,12
2022,2,3110650,76,72,4
2022,2,3110651,244,236,8
2022,2,3110652,146,135,11
2022,2,3110653,184,177,7
2022,2,3110654,528,508,20
2022,2,3110655,174,180,-6
2022,2,3110656,509,483,26
2022,2,3110657,392,373,19
2022,2,3110658,158,146,12
2022,2,3110659,531,488,43
2022,2,3110660,568,552,16
2022,2,3110661,48,48,0
2022,2,3110662,350,346,4
2022,2,3110663,98,100,-2
2022,2,3110664,76,72,4
2022,2,3110665,312,296,16
2022,2,3110666,45,36,9
2022,2,3110668,344,330,14
2022,2,3110670,164,152,12
2022,2,3110671,410,392,18
2022,2,3110672,72,64,8
2022,2,3110673,243,226,17
2022,2,3110675,194,183,11
2022,2,3110676,86,78,8
2022,2,3110677,71,64,7
2022,2,3110678,62,58,4
2022,2,3110679,65,61,4
2022,2,3110680,83,84,-1
2022,2,3110681,31,32,-1
2022,2,3110683,26,27,-1
2022,2,3110684,80,78,2
2022,2,3110686,186,186,0
2022,2,3110687,38,40,-2
2022,2,3110688,91,89,2
2022,2,3110689,158,146,12
2022,2,3110690,385,375,10
2022,2,3110691,171,164,7
2022,2,3110692,70,71,-1
2022,2,3110693,22,21,1
2022,2,3110694,272,260,12
2022,2,3110695,305,297,8
2022,2,3110696,72,65,7
2022,2,3110697,94,84,10
2022,2,3110698,126,126,0
2022,2,3110699,131,124,7
2022,2,3110700,134,129,5
2022,2,3110701,115,113,2
2022,2,3110702,104,101,3
2022,2,3110703,217,208,9
2022,2,3110706,182,179,3
2022,2,3110707,141,138,3
2022,2,3110708,60,59,1
2022,2,3110709,123,116,7
2022,2,3110710,446,432,14
2022,2,3110711,285,266,19
2022,2,3110712,278,267,11
2022,2,3110713,522,511,11
2022,2,3110714,371,373,-2
2022,2,3110715,43,40,3
2022,2,3110716,164,160,4
2022,2,3110717,432,428,4
2022,2,3110718,272,258,14
2022,2,3110719,36,35,1
2022,2,3110720,239,238,1
2022,2,3110721,142,129,13
2022,2,3110722,133,111,22
2022,2,3110723,81,74,7
2022,2,3110724,106,101,5
2022,2,3110725,145,137,8
2022,2,3110726,96,94,2
2022,2,3110727,73,53,20
2022,2,3110728,77,74,3
2022,2,3110729,211,209,2
2022,2,3110730,155,195,-40
2022,2,3110731,201,194,7
2022,2,3110732,223,213,10
2022,2,3110733,50,53,-3
2022,2,3110734,22,19,3
2022,2,3110735,224,215,9
2022,2,3110736,231,233,-2
2022,2,3110737,139,144,-5
2022,2,3110738,318,308,10
2022,2,3110739,21,21,0
2022,2,3110740,155,146,9
2022,2,3110741,202,197,5
2022,2,3110742,132,127,5
2022,2,3110743,220,207,13
2022,2,3110744,331,315,16
2022,2,3110745,170,165,5
2022,2,3110746,122,118,4
2022,2,3110747,93,87,6
2022,2,3110748,105,107,-2
2022,2,3110749,206,202,4
2022,2,3110750,174,171,3
2022,2,3110751,156,145,11
2022,2,3110752,250,241,9
2022,2,3110753,241,233,8
2022,2,3110754,165,167,-2
2022,2,3110755,167,158,9
2022,2,3110756,119,108,11
2022,2,3110757,238,237,1
2022,2,3110758,41,42,-1
2022,2,3110760,225,223,2
2022,2,3110762,639,632,7
2022,2,3110765,100,92,8
2022,2,3110766,210,200,10
2022,2,3110767,19,18,1
2022,2,3110768,90,81,9
2022,2,3110769,85,79,6
2022,2,3110770,169,168,1
2022,2,3110771,52,42,10
2022,2,3110772,36,37,-1
2022,2,3110774,132,133,-1
2022,2,3110775,103,104,-1
2022,2,3110776,155,161,-6
2022,2,3110777,66,66,0
2022,2,3110778,373,365,8
2022,2,3110780,81,74,7
2022,2,3110781,134,132,2
2022,2,3110782,74,70,4
2022,2,3110783,127,128,-1
2022,2,3110784,54,58,-4
2022,2,3110785,182,170,12
2022,2,3110786,76,68,8
2022,2,3110787,204,200,4
2022,2,3110788,44,45,-1
2022,2,3110789,198,199,-1
2022,2,3110790,181,186,-5
2022,2,3110791,35,32,3
2022,2,3110792,210,203,7
2022,2,3110794,170,155,15
2022,2,3110795,54,50,4
2022,2,3110796,44,40,4
2022,2,3110798,28,35,-7
2022,2,3110799,29,31,-2
2022,2,3110800,40,42,-2
2022,2,3110802,113,115,-2
2022,2,3110803,171,161,10
2022,2,3110804,143,130,13
2022,2,3110805,53,50,3
2022,2,3110807,88,78,10
2022,2,3110809,71,69,2
2022,2,3110810,270,267,3
2022,2,3110811,93,85,8
2022,2,3110812,111,115,-4
2022,2,3110813,294,274,20
2022,2,3110814,185,188,-3
2022,2,3110815,250,258,-8
2022,2,3110816,96,92,4
2022,2,3110817,41,40,1
2022,2,3110818,34,35,-1
2022,2,3110819,298,274,24
2022,2,3110820,197,189,8
2022,2,3110821,159,149,10
2022,2,3110822,64,64,0
2022,2,3110823,104,99,5
2022,2,3110824,82,72,10
2022,2,3110825,230,213,17
2022,2,3110826,226,219,7
2022,2,3110827,133,135,-2
2022,2,3110828,303,293,10
2022,2,3110829,74,84,-10
2022,2,3110830,94,91,3
2022,2,3110831,104,98,6
2022,2,3110832,127,125,2
2022,2,3110833,129,124,5
2022,2,3110835,79,74,5
2022,2,3110836,475,464,11
2022,2,3110837,241,236,5
2022,2,3110838,55,55,0
2022,2,3110839,210,215,-5
2022,2,3110840,202,197,5
2022,2,3110841,47,48,-1
2022,2,3110842,154,150,4
2022,2,3110843,87,79,8
2022,2,3110845,46,47,-1
2022,2,3110846,384,366,18
2022,2,3110847,77,69,8
2022,2,3110848,188,179,9
2022,2,3110849,182,176,6
2022,2,3110850,484,458,26
2022,2,3110851,106,94,12
2022,2,3110852,119,116,3
2022,2,3110853,91,85,6
2022,2,3110854,67,63,4
2022,2,3110855,400,399,1
2022,2,3110856,235,225,10
2022,2,3110857,154,146,8
2022,2,3110858,86,85,1
2022,2,3110859,80,74,6
2022,2,3110860,114,107,7
2022,2,3110861,476,459,17
2022,2,3110862,93,89,4
2022,2,3110863,188,184,4
2022,2,3110864,118,118,0
2022,2,3110865,343,337,6
2022,2,3110866,146,139,7
2022,2,3110867,138,119,19
2022,2,3110868,144,139,5
2022,2,3110869,417,396,21
2022,2,3110871,167,162,5
2022,2,3110872,57,52,5
2022,2,3110873,279,275,4
2022,2,3110874,108,116,-8
2022,2,3110875,83,76,7
2022,2,3110876,138,137,1
2022,2,3110877,217,199,18
2022,2,3110878,41,38,3
2022,2,3110879,85,89,-4
2022,2,3110880,50,50,0
2022,2,3110881,640,631,9
2022,2,3110882,232,226,6
2022,2,3110883,258,245,13
2022,2,3110884,123,119,4
2022,2,3110885,202,194,8
2022,2,3110886,132,126,6
2022,2,3110887,47,40,7
2022,2,3110888,137,130,7
2022,2,3110889,67,61,6
2022,2,3110890,153,139,14
2022,2,3110891,136,130,6
2022,2,3110892,543,520,23
2022,2,3110893,25,26,-1
2022,2,3110895,570,539,31
2022,2,3110896,123,118,5
2022,2,3110897,203,186,17
2022,2,3110899,76,68,8
2022,2,3110900,185,173,12
2022,2,3110901,132,122,10
2022,2,3110902,371,354,17
2022,2,3110903,221,224,-3
2022,2,3110904,166,158,8
2022,2,3110905,98,89,9
2022,2,3110906,61,63,-2
2022,2,3110907,303,288,15
2022,2,3110908,229,250,-21
2022,2,3110910,75,80,-5
2022,2,3110912,130,134,-4
2022,2,3110913,165,189,-24
2022,2,3110915,91,88,3
2022,2,3110916,171,166,5
2022,2,3110917,45,40,5
2022,2,3110918,121,114,7
2022,2,3110919,106,104,2
2022,2,3110921,58,56,2
2022,2,3110922,70,62,8
2022,2,3110924,87,84,3
2022,2,3110925,118,114,4
2022,2,3110926,143,138,5
2022,2,3110929,206,201,5
2022,2,3110930,96,92,4
2022,2,3110931,33,32,1
2022,2,3110932,56,57,-1
2022,2,3110934,218,183,35
2022,2,3110935,75,70,5
2022,2,3110936,86,85,1
2022,2,3110939,615,594,21
2022,2,3110940,73,72,1
2022,2,3110942,457,438,19
2022,2,3110943,170,172,-2
2022,2,3110945,19,19,0
2022,2,3110947,24,24,0
2022,2,3110949,155,132,23
2022,2,3110951,95,86,9
2022,2,3110952,41,34,7
2022,2,3110953,89,80,9
2022,2,3110954,41,42,-1
2022,2,3110955,439,412,27
2022,2,3110956,54,53,1
2022,2,3110957,348,269,79
2022,2,3110958,115,121,-6
2022,2,3110959,33,32,1
2022,2,3110961,166,157,9
2022,2,3110966,342,331,11
2022,2,3110967,127,124,3
2022,2,3110968,60,62,-2
2022,2,3110969,85,81,4
2022,2,3110970,60,56,4
2022,2,3110971,173,164,9
2022,2,3110972,60,53,7
2022,2,3110973,167,153,14
2022,2,3110974,69,60,9
2022,2,3110975,50,52,-2
2022,2,3110976,182,170,12
2022,2,3110979,60,53,7
2022,2,3110980,106,101,5
2022,2,3110981,205,198,7
2022,2,3110982,85,80,5
2022,2,3110983,105,95,10
2022,2,3110984,310,301,9
2022,2,3110988,58,56,2
2022,2,3110989,114,105,9
2022,2,3110992,385,349,36
2022,2,3110994,240,228,12
2022,2,3110995,103,99,4
2022,2,3110996,109,106,3
2022,2,3110997,623,608,15
2022,2,3110999,113,95,18
2022,2,3111001,63,55,8
2022,2,3111003,572,544,28
2022,2,3111004,664,641,23
2022,2,3111005,310,297,13
2022,2,3111006,473,457,16
2022,2,3111007,257,235,22
2022,2,3111008,240,231,9
2022,2,3111009,99,98,1
2022,2,3111010,442,411,31
2022,2,3111011,109,103,6
2022,2,3111012,281,260,21
2022,2,3111013,585,556,29
2022,2,3111014,165,155,10
2022,2,3111015,426,401,25
2022,2,3111016,171,168,3
2022,2,3111017,71,66,5
2022,2,3111019,319,300,19
2022,2,3111020,143,136,7
2022,2,3111021,710,682,28
2022,2,3111022,98,94,4
2022,2,3111023,156,149,7
2022,2,3111024,79,76,3
2022,2,3111025,128,125,3
2022,2,3111026,294,271,23
2022,2,3111027,320,306,14
2022,2,3111028,169,162,7
2022,2,3111029,91,93,-2
2022,2,3111030,184,178,6
2022,2,3111031,151,148,3
2022,2,3111032,199,201,-2
2022,2,3111033,61,61,0
2022,2,3111034,233,220,13
2022,2,3111035,136,128,8
2022,2,3111036,62,63,-1
2022,2,3111037,43,46,-3
2022,2,3111038,166,159,7
2022,2,3111039,143,136,7
2022,2,3111040,63,62,1
2022,2,3111042,289,269,20
2022,2,3111043,60,60,0
2022,2,3111044,284,275,9
2022,2,3111045,45,41,4
2022,2,3111046,500,500,0
2022,2,3111047,80,73,7
2022,2,3111049,217,201,16
2022,2,3111051,319,298,21
2022,2,3111052,294,282,12
2022,2,3111053,253,235,18
2022,2,3111054,49,48,1
2022,2,3111055,30,29,1
2022,2,3111056,93,66,27
2022,2,3111057,234,224,10
2022,2,3111058,86,81,5
2022,2,3111059,632,592,40
2022,2,3111060,539,523,16
2022,2,3111061,358,351,7
2022,2,3111062,175,168,7
2022,2,3111063,223,212,11
2022,2,3111064,148,140,8
2022,2,3111065,71,68,3
2022,2,3111066,213,202,11
2022,2,3111067,345,328,17
2022,2,3111068,37,37,0
2022,2,3111069,134,131,3
2022,2,3111070,76,76,0
2022,2,3111071,48,51,-3
2022,2,3111072,235,219,16
2022,2,3111073,365,357,8
2022,2,3111074,104,103,1
2022,2,3111075,140,133,7
2022,2,3111076,161,164,-3
2022,2,3111077,569,559,10
2022,2,3111078,557,532,25
2022,2,3111079,90,84,6
2022,2,3111080,204,196,8
2022,2,3111082,29,23,6
2022,2,3111083,186,182,4
2022,2,3111084,40,44,-4
2022,2,3111085,276,271,5
2022,2,3111086,221,212,9
2022,2,3111087,106,99,7
2022,2,3111088,171,161,10
2022,2,3111089,432,422,10
2022,3,3110001,41,45,-4
2022,3,3110002,100,101,-1
2022,3,3110003,133,134,-1
2022,3,3110004,31,29,2
2022,3,3110005,87,89,-2
2022,3,3110006,25,22,3
2022,3,3110007,75,72,3
2022,3,3110008,248,234,14
2022,3,3110009,107,100,7
2022,3,3110010,189,186,3
2022,3,3110012,617,614,3
2022,3,3110014,45,47,-2
2022,3,3110016,114,112,2
2022,3,3110017,53,51,2
2022,3,3110018,161,152,9
2022,3,3110020,117,110,7
2022,3,3110021,132,131,1
2022,3,3110022,105,104,1
2022,3,3110023,47,43,4
2022,3,3110024,118,113,5
2022,3,3110025,62,62,0
2022,3,3110027,70,64,6
2022,3,3110028,210,203,7
2022,3,3110029,178,174,4
2022,3,3110030,35,35,0
2022,3,3110031,63,63,0
2022,3,3110033,113,112,1
2022,3,3110035,155,156,-1
2022,3,3110036,63,54,9
2022,3,3110037,119,116,3
2022,3,3110039,23,24,-1
2022,3,3110040,117,123,-6
2022,3,3110041,150,151,-1
2022,3,3110042,70,72,-2
2022,3,3110043,217,223,-6
2022,3,3110045,108,115,-7
2022,3,3110047,60,56,4
2022,3,3110048,156,152,4
2022,3,3110049,157,154,3
2022,3,3110050,53,55,-2
2022,3,3110051,74,73,1
2022,3,3110052,190,188,2
2022,3,3110053,223,221,2
2022,3,3110054,277,286,-9
2022,3,3110055,110,108,2
2022,3,3110056,422,410,12
2022,3,3110057,151,159,-8
2022,3,3110058,276,283,-7
2022,3,3110059,135,139,-4
2022,3,3110060,175,177,-2
2022,3,3110061,117,112,5
2022,3,3110062,258,234,24
2022,3,3110063,284,276,8
2022,3,3110064,186,184,2
2022,3,3110065,65,66,-1
2022,3,3110066,203,199,4
2022,3,3110067,209,201,8
2022,3,3110068,322,311,11
2022,3,3110069,498,495,3
2022,3,3110070,38,38,0
2022,3,3110071,79,82,-3
2022,3,3110073,97,91,6
2022,3,3110074,232,219,13
2022,3,3110075,140,142,-2
2022,3,3110077,84,84,0
2022,3,3110078,88,89,-1
2022,3,3110079,379,376,3
2022,3,3110080,171,162,9
2022,3,3110081,258,244,14
2022,3,3110082,156,149,7
2022,3,3110083,84,79,5
2022,3,3110084,389,371,18
2022,3,3110085,352,334,18
2022,3,3110087,127,126,1
2022,3,3110088,90,93,-3
2022,3,3110089,63,59,4
2022,3,3110090,126,124,2
2022,3,3110092,158,147,11
2022,3,3110093,393,389,4
2022,3,3110095,262,245,17
2022,3,3110096,70,68,2
2022,3,3110098,71,75,-4
2022,3,3110099,104,98,6
2022,3,3110102,170,162,8
2022,3,3110103,36,38,-2
2022,3,3110104,105,101,4
2022,3,3110105,139,137,2
2022,3,3110107,53,50,3
2022,3,3110109,145,144,1
2022,3,3110110,106,104,2
2022,3,3110112,132,134,-2
2022,3,3110113,63,60,3
2022,3,3110114,128,103,25
2022,3,3110115,205,199,6
2022,3,3110116,212,214,-2
2022,3,3110117,83,88,-5
2022,3,3110118,176,169,7
2022,3,3110120,123,103,20
2022,3,3110121,73,78,-5
2022,3,3110122,217,216,1
2022,3,3110123,164,161,3
2022,3,3110124,195,184,11
2022,3,3110125,132,130,2
2022,3,3110126,33,29,4
2022,3,3110127,133,125,8
2022,3,3110128,523,522,1
2022,3,3110129,173,162,11
2022,3,3110130,46,47,-1
2022,3,3110131,462,442,20
2022,3,3110132,134,117,17
2022,3,3110133,89,91,-2
2022,3,3110134,330,329,1
2022,3,3110135,169,171,-2
2022,3,3110136,463,417,46
2022,3,3110137,689,694,-5
2022,3,3110138,164,170,-6
2022,3,3110139,290,281,9
2022,3,3110140,382,371,11
2022,3,3110141,126,122,4
2022,3,3110142,272,264,8
2022,3,3110144,64,64,0
2022,3,3110146,201,201,0
2022,3,3110147,246,239,7
2022,3,3110148,81,82,-1
2022,3,3110149,56,51,5
2022,3,3110150,260,255,5
2022,3,3110151,254,246,8
2022,3,3110152,101,98,3
2022,3,3110153,67,61,6
2022,3,3110154,264,265,-1
2022,3,3110155,171,158,13
2022,3,3110156,196,187,9
2022,3,3110157,244,230,14
2022,3,3110158,344,345,-1
2022,3,3110159,455,439,16
2022,3,3110160,56,55,1
2022,3,3110161,301,307,-6
2022,3,3110162,150,148,2
2022,3,3110163,199,204,-5
2022,3,3110164,94,91,3
2022,3,3110165,180,174,6
2022,3,3110166,345,335,10
2022,3,3110167,312,306,6
2022,3,3110168,113,114,-1
2022,3,3110169,134,136,-2
2022,3,3110170,261,253,8
2022,3,3110171,35,38,-3
2022,3,3110172,164,137,27
2022,3,3110173,92,91,1
2022,3,3110174,231,233,-2
2022,3,3110175,164,164,0
2022,3,3110176,230,223,7
2022,3,3110177,46,43,3
2022,3,3110178,60,58,2
2022,3,3110179,113,112,1
2022,3,3110180,231,233,-2
2022,3,3110181,237,227,10
2022,3,3110182,103,103,0
2022,3,3110183,112,108,4
2022,3,3110184,44,41,3
2022,3,3110185,49,47,2
2022,3,3110186,58,60,-2
2022,3,3110187,395,370,25
2022,3,3110188,225,226,-1
2022,3,3110189,108,108,0
2022,3,3110190,103,105,-2
2022,3,3110191,157,149,8
2022,3,3110193,92,94,-2
2022,3,3110194,135,137,-2
2022,3,3110195,232,245,-13
2022,3,3110197,35,33,2
2022,3,3110199,164,168,-4
2022,3,3110200,43,42,1
2022,3,3110201,39,39,0
2022,3,3110203,85,81,4
2022,3,3110204,259,257,2
2022,3,3110205,266,248,18
2022,3,3110206,176,167,9
2022,3,3110207,76,79,-3
2022,3,3110208,50,49,1
2022,3,3110209,61,66,-5
2022,3,3110210,160,153,7
2022,3,3110211,217,219,-2
2022,3,3110212,233,227,6
2022,3,3110213,39,39,0
2022,3,3110214,104,102,2
2022,3,3110215,68,69,-1
2022,3,3110216,154,148,6
2022,3,3110217,417,423,-6
2022,3,3110218,196,202,-6
2022,3,3110219,283,270,13
2022,3,3110220,357,350,7
2022,3,3110221,54,53,1
2022,3,3110224,84,83,1
2022,3,3110225,164,161,3
2022,3,3110226,780,781,-1
2022,3,3110227,136,138,-2
2022,3,3110228,337,329,8
2022,3,3110229,374,367,7
2022,3,3110230,176,177,-1
2022,3,3110232,278,283,-5
2022,3,3110233,154,149,5
2022,3,3110234,63,70,-7
2022,3,3110236,336,337,-1
2022,3,3110237,302,299,3
2022,3,3110238,44,39,5
2022,3,3110240,146,140,6
2022,3,3110241,320,297,23
2022,3,3110242,150,150,0
2022,3,3110243,289,292,-3
2022,3,3110244,189,192,-3
2022,3,3110245,58,54,4
2022,3,3110246,204,188,16
2022,3,3110247,277,275,2
2022,3,3110248,49,49,0
2022,3,3110249,294,303,-9
2022,3,3110250,77,76,1
2022,3,3110251,188,177,11
2022,3,3110252,224,224,0
2022,3,3110253,196,191,5
2022,3,3110254,343,347,-4
2022,3,3110255,324,319,5
2022,3,3110256,311,297,14
2022,3,3110257,118,117,1
2022,3,3110258,209,195,14
2022,3,3110259,229,228,1
2022,3,3110260,172,168,4
2022,3,3110261,182,180,2
2022,3,3110262,321,308,13
2022,3,3110263,207,202,5
2022,3,3110264,395,393,2
2022,3,3110265,139,140,-1
2022,3,3110266,197,196,1
2022,3,3110267,213,216,-3
2022,3,3110268,93,90,3
2022,3,3110269,86,84,2
2022,3,3110270,71,67,4
2022,3,3110271,36,34,2
2022,3,3110272,393,400,-7
2022,3,3110273,139,133,6
2022,3,3110274,274,280,-6
2022,3,3110275,93,88,5
2022,3,3110276,29,27,2
2022,3,3110277,199,192,7
2022,3,3110278,294,301,-7
2022,3,3110280,38,38,0
2022,3,3110281,49,50,-1
2022,3,3110282,61,63,-2
2022,3,3110283,76,74,2
2022,3,3110284,47,47,0
2022,3,3110285,93,95,-2
2022,3,3110286,167,169,-2
2022,3,3110287,50,47,3
2022,3,3110288,107,114,-7
2022,3,3110289,129,119,10
2022,3,3110290,42,44,-2
2022,3,3110291,230,225,5
2022,3,3110292,45,45,0
2022,3,3110293,200,197,3
2022,3,3110294,191,184,7
2022,3,3110295,170,175,-5
2022,3,3110296,182,178,4
2022,3,3110297,240,232,8
2022,3,3110298,45,44,1
2022,3,3110299,294,285,9
2022,3,3110300,308,302,6
2022,3,3110301,144,144,0
2022,3,3110302,173,168,5
2022,3,3110303,170,164,6
2022,3,3110304,142,130,12
2022,3,3110305,246,248,-2
2022,3,3110306,90,92,-2
2022,3,3110307,140,148,-8
2022,3,3110308,187,186,1
2022,3,3110309,95,95,0
2022,3,3110310,22,22,0
2022,3,3110312,153,149,4
2022,3,3110313,315,320,-5
2022,3,3110314,256,262,-6
2022,3,3110315,209,216,-7
2022,3,3110316,380,366,14
2022,3,3110317,130,128,2
2022,3,3110318,85,83,2
2022,3,3110319,233,236,-3
2022,3,3110320,54,54,0
2022,3,3110322,80,83,-3
2022,3,3110323,179,176,3
2022,3,3110325,151,144,7
2022,3,3110326,34,36,-2
2022,3,3110327,152,157,-5
2022,3,3110328,86,85,1
2022,3,3110329,96,97,-1
2022,3,3110330,118,119,-1
2022,3,3110331,194,186,8
2022,3,3110332,66,68,-2
2022,3,3110333,190,187,3
2022,3,3110334,140,136,4
2022,3,3110335,296,294,2
2022,3,3110336,66,66,0
2022,3,3110337,89,99,-10
2022,3,3110340,54,54,0
2022,3,3110341,96,90,6
2022,3,3110342,57,55,2
2022,3,3110343,115,110,5
2022,3,3110344,23,23,0
2022,3,3110345,138,131,7
2022,3,3110346,83,84,-1
2022,3,3110348,151,145,6
2022,3,3110349,30,32,-2
2022,3,3110350,91,97,-6
2022,3,3110351,109,109,0
2022,3,3110352,194,183,11
2022,3,3110353,116,120,-4
2022,3,3110354,74,74,0
2022,3,3110355,127,120,7
2022,3,3110356,108,105,3
2022,3,3110357,112,113,-1
2022,3,3110358,148,143,5
2022,3,3110359,173,166,7
2022,3,3110360,211,220,-9
2022,3,3110361,86,90,-4
2022,3,3110362,201,197,4
2022,3,3110363,43,43,0
2022,3,3110364,178,183,-5
2022,3,3110365,140,144,-4
2022,3,3110366,125,121,4
2022,3,3110367,153,146,7
2022,3,3110368,153,152,1
2022,3,3110369,305,305,0
2022,3,3110370,166,158,8
2022,3,3110371,143,140,3
2022,3,3110372,132,130,2
2022,3,3110373,182,176,6
2022,3,3110374,349,348,1
2022,3,3110375,73,72,1
2022,3,3110376,348,348,0
2022,3,3110377,95,94,1
2022,3,3110378,115,111,4
2022,3,3110379,46,47,-1
2022,3,3110380,29,26,3
2022,3,3110381,50,56,-6
2022,3,3110382,64,62,2
2022,3,3110383,101,104,-3
2022,3,3110387,179,177,2
2022,3,3110388,84,79,5
2022,3,3110389,69,69,0
2022,3,3110390,174,171,3
2022,3,3110391,123,124,-1
2022,3,3110392,68,65,3
2022,3,3110393,55,59,-4
2022,3,3110394,254,249,5
2022,3,3110395,114,114,0
2022,3,3110396,215,212,3
2022,3,3110397,395,394,1
2022,3,3110398,235,233,2
2022,3,3110399,269,261,8
2022,3,3110400,262,265,-3
2022,3,3110401,59,61,-2
2022,3,3110402,182,177,5
2022,3,3110403,355,349,6
2022,3,3110404,436,422,14
2022,3,3110405,420,416,4
2022,3,3110406,132,131,1
2022,3,3110407,329,338,-9
2022,3,3110408,106,107,-1
2022,3,3110409,264,266,-2
2022,3,3110410,273,269,4
2022,3,3110411,123,118,5
2022,3,3110412,23,22,1
2022,3,3110413,84,80,4
2022,3,3110415,487,500,-13
2022,3,3110416,176,177,-1
2022,3,3110417,43,41,2
2022,3,3110418,70,70,0
2022,3,3110419,353,363,-10
2022,3,3110420,163,160,3
2022,3,3110421,220,220,0
2022,3,3110422,104,107,-3
2022,3,3110423,143,144,-1
2022,3,3110424,258,256,2
2022,3,3110425,261,255,6
2022,3,3110426,261,248,13
2022,3,3110427,45,45,0
2022,3,3110428,435,432,3
2022,3,3110429,428,430,-2
2022,3,3110431,371,365,6
2022,3,3110432,130,135,-5
2022,3,3110433,220,202,18
2022,3,3110434,103,102,1
2022,3,3110435,83,88,-5
2022,3,3110436,76,73,3
2022,3,3110437,134,140,-6
2022,3,3110438,335,333,2
2022,3,3110439,137,139,-2
2022,3,3110440,72,51,21
2022,3,3110441,171,173,-2
2022,3,3110442,50,48,2
2022,3,3110443,51,49,2
2022,3,3110444,20,19,1
2022,3,3110446,66,68,-2
2022,3,3110447,40,41,-1
2022,3,3110448,80,80,0
2022,3,3110449,219,219,0
2022,3,3110450,359,357,2
2022,3,3110451,251,252,-1
2022,3,3110452,182,190,-8
2022,3,3110453,308,305,3
2022,3,3110454,144,146,-2
2022,3,3110455,297,287,10
2022,3,3110456,342,334,8
2022,3,3110457,123,124,-1
2022,3,3110458,234,237,-3
2022,3,3110459,240,242,-2
2022,3,3110460,323,313,10
2022,3,3110461,69,67,2
2022,3,3110462,161,155,6
2022,3,3110463,99,103,-4
2022,3,3110464,203,197,6
2022,3,3110465,222,218,4
2022,3,3110466,143,139,4
2022,3,3110467,191,196,-5
2022,3,3110468,461,441,20
2022,3,3110469,437,441,-4
2022,3,3110470,117,115,2
2022,3,3110471,215,207,8
2022,3,3110472,295,278,17
2022,3,3110473,360,334,26
2022,3,3110474,137,132,5
2022,3,3110475,132,127,5
2022,3,3110476,62,58,4
2022,3,3110477,229,230,-1
2022,3,3110478,148,147,1
2022,3,3110479,179,180,-1
2022,3,3110480,100,96,4
2022,3,3110481,285,281,4
2022,3,3110482,49,55,-6
2022,3,3110483,67,65,2
2022,3,3110484,185,181,4
2022,3,3110485,133,126,7
2022,3,3110486,199,187,12
2022,3,3110487,69,72,-3
2022,3,3110488,178,172,6
2022,3,3110489,73,70,3
2022,3,3110490,118,119,-1
2022,3,3110491,40,38,2
2022,3,3110493,83,82,1
2022,3,3110495,250,249,1
2022,3,3110496,221,217,4
2022,3,3110498,122,116,6
2022,3,3110499,143,138,5
2022,3,3110500,52,52,0
2022,3,3110501,60,63,-3
2022,3,3110502,287,277,10
2022,3,3110503,341,332,9
2022,3,3110505,18,19,-1
2022,3,3110506,42,41,1
2022,3,3110507,441,434,7
2022,3,3110508,133,126,7
2022,3,3110509,359,353,6
2022,3,3110510,79,79,0
2022,3,3110511,134,125,9
2022,3,3110512,99,96,3
2022,3,3110513,106,97,9
2022,3,3110514,52,54,-2
2022,3,3110515,46,52,-6
2022,3,3110517,72,74,-2
2022,3,3110519,100,109,-9
2022,3,3110520,91,90,1
2022,3,3110521,80,77,3
2022,3,3110522,54,52,2
2022,3,3110523,19,22,-3
2022,3,3110524,52,49,3
2022,3,3110525,139,142,-3
2022,3,3110526,37,39,-2
2022,3,3110527,135,123,12
2022,3,3110528,115,110,5
2022,3,3110529,219,209,10
2022,3,3110532,125,123,2
2022,3,3110533,24,25,-1
2022,3,3110534,52,50,2
2022,3,3110535,63,57,6
2022,3,3110536,42,42,0
2022,3,3110537,155,155,0
2022,3,3110538,70,70,0
2022,3,3110539,92,90,2
2022,3,3110540,90,86,4
2022,3,3110541,280,270,10
2022,3,3110542,306,299,7
2022,3,3110543,31,29,2
2022,3,3110544,1092,1019,73
2022,3,3110545,271,248,23
2022,3,3110546,87,80,7
2022,3,3110547,260,259,1
2022,3,3110548,172,166,6
2022,3,3110549,120,119,1
2022,3,3110550,410,405,5
2022,3,3110551,201,196,5
2022,3,3110552,138,132,6
2022,3,3110553,176,169,7
2022,3,3110554,259,256,3
2022,3,3110555,72,74,-2
2022,3,3110557,288,290,-2
2022,3,3110558,435,423,12
2022,3,3110559,456,453,3
2022,3,3110560,121,114,7
2022,3,3110561,164,162,2
2022,3,3110562,278,269,9
2022,3,3110563,58,54,4
2022,3,3110564,233,217,16
2022,3,3110565,86,84,2
2022,3,3110566,549,517,32
2022,3,3110567,84,89,-5
2022,3,3110568,83,81,2
2022,3,3110569,309,303,6
2022,3,3110570,69,69,0
2022,3,3110571,132,134,-2
2022,3,3110572,267,266,1
2022,3,3110573,30,31,-1
2022,3,3110574,48,46,2
2022,3,3110575,70,66,4
2022,3,3110576,234,224,10
2022,3,3110577,131,123,8
2022,3,3110578,314,320,-6
2022,3,3110579,78,76,2
2022,3,3110580,65,56,9
2022,3,3110582,167,165,2
2022,3,3110583,48,47,1
2022,3,3110584,66,69,-3
2022,3,3110585,50,49,1
2022,3,3110586,342,344,-2
2022,3,3110587,146,144,2
2022,3,3110588,91,99,-8
2022,3,3110589,39,37,2
2022,3,3110590,132,126,6
2022,3,3110591,87,93,-6
2022,3,3110592,60,58,2
2022,3,3110593,243,246,-3
2022,3,3110594,119,116,3
2022,3,3110595,279,284,-5
2022,3,3110596,113,102,11
2022,3,3110597,237,247,-10
2022,3,3110598,224,232,-8
2022,3,3110599,196,192,4
2022,3,3110600,190,186,4
2022,3,3110601,274,278,-4
2022,3,3110602,100,102,-2
2022,3,3110603,84,82,2
2022,3,3110604,230,234,-4
2022,3,3110605,99,87,12
2022,3,3110606,288,283,5
2022,3,3110607,62,55,7
2022,3,3110608,218,217,1
2022,3,3110609,57,57,0
2022,3,3110611,109,108,1
2022,3,3110612,286,281,5
2022,3,3110613,44,51,-7
2022,3,3110614,189,179,10
2022,3,3110615,145,144,1
2022,3,3110616,45,46,-1
2022,3,3110617,93,93,0
2022,3,3110618,231,220,11
2022,3,3110619,87,80,7
2022,3,3110620,380,375,5
2022,3,3110621,74,72,2
2022,3,3110622,166,166,0
2022,3,3110624,56,58,-2
2022,3,3110625,390,376,14
2022,3,3110626,183,177,6
2022,3,3110627,260,251,9
2022,3,3110628,69,63,6
2022,3,3110629,26,24,2
2022,3,3110630,258,259,-1
2022,3,3110631,97,103,-6
2022,3,3110632,157,149,8
2022,3,3110633,92,91,1
2022,3,3110634,448,434,14
2022,3,3110635,146,137,9
2022,3,3110636,102,107,-5
2022,3,3110637,115,114,1
2022,3,3110638,436,431,5
2022,3,3110639,104,106,-2
2022,3,3110640,168,167,1
2022,3,3110641,102,99,3
2022,3,3110643,204,200,4
2022,3,3110644,32,32,0
2022,3,3110645,365,362,3
2022,3,3110646,414,395,19
2022,3,3110647,385,383,2
2022,3,3110649,202,199,3
2022,3,3110650,78,75,3
2022,3,3110651,243,236,7
2022,3,3110652,141,137,4
2022,3,3110653,180,183,-3
2022,3,3110654,516,524,-8
2022,3,3110655,173,175,-2
2022,3,3110656,501,492,9
2022,3,3110657,389,376,13
2022,3,3110658,156,152,4
2022,3,3110659,525,497,28
2022,3,3110660,563,558,5
2022,3,3110661,49,49,0
2022,3,3110662,349,349,0
2022,3,3110663,100,100,0
2022,3,3110664,75,72,3
2022,3,3110665,305,305,0
2022,3,3110666,42,38,4
2022,3,3110668,343,332,11
2022,3,3110670,165,155,10
2022,3,3110671,400,398,2
2022,3,3110672,71,69,2
2022,3,3110673,241,237,4
2022,3,3110675,192,188,4
2022,3,3110676,86,82,4
2022,3,3110677,70,66,4
2022,3,3110678,61,58,3
2022,3,3110679,69,60,9
2022,3,3110680,82,84,-2
2022,3,3110681,31,33,-2
2022,3,3110683,27,28,-1
2022,3,3110684,81,78,3
2022,3,3110686,181,187,-6
2022,3,3110687,37,39,-2
2022,3,3110688,90,89,1
2022,3,3110689,156,153,3
2022,3,3110690,381,375,6
2022,3,3110691,166,163,3
2022,3,3110692,66,70,-4
2022,3,3110693,22,24,-2
2022,3,3110694,266,266,0
2022,3,3110695,305,303,2
2022,3,3110696,71,68,3
2022,3,3110697,95,92,3
2022,3,3110698,123,128,-5
2022,3,3110699,131,126,5
2022,3,3110700,132,131,1
2022,3,3110701,113,115,-2
2022,3,3110702,102,105,-3
2022,3,3110703,214,210,4
2022,3,3110706,181,180,1
2022,3,3110707,135,142,-7
2022,3,3110708,60,61,-1
2022,3,3110709,121,121,0
2022,3,3110710,436,433,3
2022,3,3110711,285,269,16
2022,3,3110712,273,266,7
2022,3,3110713,512,512,0
2022,3,3110714,375,373,2
2022,3,3110715,42,40,2
2022,3,3110716,166,162,4
2022,3,3110717,422,439,-17
2022,3,3110718,270,261,9
2022,3,3110719,36,36,0
2022,3,3110720,237,241,-4
2022,3,3110721,136,135,1
2022,3,3110722,133,119,14
2022,3,3110723,79,74,5
2022,3,3110724,102,101,1
2022,3,3110725,148,139,9
2022,3,3110726,93,94,-1
2022,3,3110727,71,61,10
2022,3,3110728,78,76,2
2022,3,3110729,209,214,-5
2022,3,3110730,160,200,-40
2022,3,3110731,200,197,3
2022,3,3110732,222,215,7
2022,3,3110733,47,54,-7
2022,3,3110734,21,21,0
2022,3,3110735,221,216,5
2022,3,3110736,228,234,-6
2022,3,3110737,138,144,-6
2022,3,3110738,318,305,13
2022,3,3110739,21,22,-1
2022,3,3110740,149,147,2
2022,3,3110741,205,203,2
2022,3,3110742,131,126,5
2022,3,3110743,217,206,11
2022,3,3110744,324,322,2
2022,3,3110745,167,165,2
2022,3,3110746,116,117,-1
2022,3,3110747,95,90,5
2022,3,3110748,106,108,-2
2022,3,3110749,205,209,-4
2022,3,3110750,169,173,-4
2022,3,3110751,155,152,3
2022,3,3110752,245,240,5
2022,3,3110753,245,231,14
2022,3,3110754,165,168,-3
2022,3,3110755,165,162,3
2022,3,3110756,118,110,8
2022,3,3110757,235,238,-3
2022,3,3110758,40,43,-3
2022,3,3110760,224,225,-1
2022,3,3110762,626,636,-10
2022,3,3110765,101,92,9
2022,3,3110766,210,203,7
2022,3,3110767,19,18,1
2022,3,3110768,88,84,4
2022,3,3110769,83,80,3
2022,3,3110770,173,169,4
2022,3,3110771,51,45,6
2022,3,3110772,36,37,-1
2022,3,3110774,127,129,-2
2022,3,3110775,101,104,-3
2022,3,3110776,154,162,-8
2022,3,3110777,64,65,-1
2022,3,3110778,372,367,5
2022,3,3110780,81,77,4
2022,3,3110781,133,132,1
2022,3,3110782,73,74,-1
2022,3,3110783,128,128,0
2022,3,3110784,53,56,-3
2022,3,3110785,185,168,17
2022,3,3110786,76,71,5
2022,3,3110787,199,198,1
2022,3,3110788,42,45,-3
2022,3,3110789,196,193,3
2022,3,3110790,176,186,-10
2022,3,3110791,36,34,2
2022,3,3110792,210,209,1
2022,3,3110794,167,168,-1
2022,3,3110795,53,47,6
2022,3,3110796,42,42,0
2022,3,3110798,33,35,-2
2022,3,3110799,28,32,-4
2022,3,3110800,40,42,-2
2022,3,3110802,113,113,0
2022,3,3110803,160,161,-1
2022,3,3110804,143,134,9
2022,3,3110805,51,51,0
2022,3,3110807,90,76,14
2022,3,3110809,69,71,-2
2022,3,3110810,267,268,-1
2022,3,3110811,95,89,6
2022,3,3110812,108,111,-3
2022,3,3110813,292,283,9
2022,3,3110814,186,185,1
2022,3,3110815,250,258,-8
2022,3,3110816,94,95,-1
2022,3,3110817,39,41,-2
2022,3,3110818,34,35,-1
2022,3,3110819,298,283,15
2022,3,3110820,199,191,8
2022,3,3110821,157,150,7
2022,3,3110822,63,66,-3
2022,3,3110823,102,100,2
2022,3,3110824,82,72,10
2022,3,3110825,226,220,6
2022,3,3110826,222,219,3
2022,3,3110827,129,135,-6
2022,3,3110828,298,302,-4
2022,3,3110829,69,84,-15
2022,3,3110830,97,97,0
2022,3,3110831,104,98,6
2022,3,3110832,125,126,-1
2022,3,3110833,130,127,3
2022,3,3110835,79,75,4
2022,3,3110836,474,468,6
2022,3,3110837,242,240,2
2022,3,3110838,53,57,-4
2022,3,3110839,210,213,-3
2022,3,3110840,194,198,-4
2022,3,3110841,41,48,-7
2022,3,3110842,153,152,1
2022,3,3110843,83,81,2
2022,3,3110845,48,46,2
2022,3,3110846,380,372,8
2022,3,3110847,71,69,2
2022,3,3110848,187,177,10
2022,3,3110849,175,182,-7
2022,3,3110850,483,467,16
2022,3,3110851,104,100,4
2022,3,3110852,118,117,1
2022,3,3110853,88,87,1
2022,3,3110854,69,63,6
2022,3,3110855,387,396,-9
2022,3,3110856,233,231,2
2022,3,3110857,152,146,6
2022,3,3110858,84,85,-1
2022,3,3110859,79,77,2
2022,3,3110860,113,112,1
2022,3,3110861,468,468,0
2022,3,3110862,92,93,-1
2022,3,3110863,187,186,1
2022,3,3110864,118,126,-8
2022,3,3110865,333,337,-4
2022,3,3110866,145,138,7
2022,3,3110867,135,127,8
2022,3,3110868,149,140,9
2022,3,3110869,417,400,17
2022,3,3110871,166,163,3
2022,3,3110872,57,52,5
2022,3,3110873,276,276,0
2022,3,3110874,100,115,-15
2022,3,3110875,78,77,1
2022,3,3110876,139,138,1
2022,3,3110877,209,204,5
2022,3,3110878,40,40,0
2022,3,3110879,82,88,-6
2022,3,3110880,51,49,2
2022,3,3110881,638,637,1
2022,3,3110882,229,225,4
2022,3,3110883,253,248,5
2022,3,3110884,116,121,-5
2022,3,3110885,196,199,-3
2022,3,3110886,128,125,3
2022,3,3110887,46,43,3
2022,3,3110888,136,130,6
2022,3,3110889,67,63,4
2022,3,3110890,151,148,3
2022,3,3110891,136,131,5
2022,3,3110892,535,524,11
2022,3,3110893,25,27,-2
2022,3,3110895,560,557,3
2022,3,3110896,123,120,3
2022,3,3110897,204,193,11
2022,3,3110899,74,69,5
2022,3,3110900,183,178,5
2022,3,3110901,131,122,9
2022,3,3110902,369,357,12
2022,3,3110903,224,222,2
2022,3,3110904,164,163,1
2022,3,3110905,97,93,4
2022,3,3110906,57,63,-6
2022,3,3110907,301,288,13
2022,3,3110908,225,247,-22
2022,3,3110910,73,81,-8
2022,3,3110912,130,134,-4
2022,3,3110913,161,191,-30
2022,3,3110915,88,90,-2
2022,3,3110916,172,166,6
2022,3,3110917,44,41,3
2022,3,3110918,122,116,6
2022,3,3110919,106,103,3
2022,3,3110921,59,55,4
2022,3,3110922,68,64,4
2022,3,3110924,86,82,4
2022,3,3110925,120,117,3
2022,3,3110926,143,140,3
2022,3,3110929,206,200,6
2022,3,3110930,95,93,2
2022,3,3110931,37,30,7
2022,3,3110932,55,57,-2
2022,3,3110934,218,195,23
2022,3,3110935,74,71,3
2022,3,3110936,84,84,0
2022,3,3110939,608,606,2
2022,3,3110940,70,73,-3
2022,3,3110942,454,444,10
2022,3,3110943,169,172,-3
2022,3,3110945,19,18,1
2022,3,3110947,23,24,-1
2022,3,3110949,155,133,22
2022,3,3110951,93,87,6
2022,3,3110952,39,35,4
2022,3,3110953,88,81,7
2022,3,3110954,41,42,-1
2022,3,3110955,445,422,23
2022,3,3110956,54,52,2
2022,3,3110957,341,300,41
2022,3,3110958,110,122,-12
2022,3,3110959,34,31,3
2022,3,3110961,169,154,15
2022,3,3110966,342,332,10
2022,3,3110967,127,127,0
2022,3,3110968,61,61,0
2022,3,3110969,86,83,3
2022,3,3110970,64,57,7
2022,3,3110971,171,161,10
2022,3,3110972,61,56,5
2022,3,3110973,167,158,9
2022,3,3110974,69,64,5
2022,3,3110975,50,48,2
2022,3,3110976,181,173,8
2022,3,3110979,59,56,3
2022,3,3110980,107,103,4
2022,3,3110981,201,199,2
2022,3,3110982,88,83,5
2022,3,3110983,108,98,10
2022,3,3110984,315,300,15
2022,3,3110988,58,60,-2
2022,3,3110989,110,106,4
2022,3,3110992,382,368,14
2022,3,3110994,242,231,11
2022,3,3110995,101,98,3
2022,3,3110996,107,105,2
2022,3,3110997,626,612,14
2022,3,3110999,120,101,19
2022,3,3111001,61,58,3
2022,3,3111003,567,551,16
2022,3,3111004,656,646,10
2022,3,3111005,308,308,0
2022,3,3111006,461,471,-10
2022,3,3111007,256,242,14
2022,3,3111008,240,236,4
2022,3,3111009,97,97,0
2022,3,3111010,441,417,24
2022,3,3111011,110,105,5
2022,3,3111012,279,267,12
2022,3,3111013,586,568,18
2022,3,3111014,162,157,5
2022,3,3111015,427,407,20
2022,3,3111016,170,171,-1
2022,3,3111017,70,66,4
2022,3,3111019,314,313,1
2022,3,3111020,142,136,6
2022,3,3111021,703,682,21
2022,3,3111022,97,96,1
2022,3,3111023,153,150,3
2022,3,3111024,79,78,1
2022,3,3111025,123,126,-3
2022,3,3111026,290,274,16
2022,3,3111027,323,308,15
2022,3,3111028,169,164,5
2022,3,3111029,89,93,-4
2022,3,3111030,182,178,4
2022,3,3111031,151,149,2
2022,3,3111032,200,201,-1
2022,3,3111033,60,61,-1
2022,3,3111034,229,223,6
2022,3,3111035,131,130,1
2022,3,3111036,59,63,-4
2022,3,3111037,43,46,-3
2022,3,3111038,164,159,5
2022,3,3111039,139,136,3
2022,3,3111040,64,62,2
2022,3,3111042,286,279,7
2022,3,3111043,60,58,2
2022,3,3111044,283,274,9
2022,3,3111045,44,42,2
2022,3,3111046,498,498,0
2022,3,3111047,80,75,5
2022,3,3111049,209,212,-3
2022,3,3111051,324,306,18
2022,3,3111052,288,292,-4
2022,3,3111053,249,250,-1
2022,3,3111054,50,48,2
2022,3,3111055,29,29,0
2022,3,3111056,91,76,15
2022,3,3111057,230,228,2
2022,3,3111058,86,80,6
2022,3,3111059,625,594,31
2022,3,3111060,518,529,-11
2022,3,3111061,349,348,1
2022,3,3111062,169,168,1
2022,3,3111063,215,215,0
2022,3,3111064,149,140,9
2022,3,3111065,69,71,-2
2022,3,3111066,211,209,2
2022,3,3111067,340,341,-1
2022,3,3111068,33,39,-6
2022,3,3111069,135,133,2
2022,3,3111070,71,79,-8
2022,3,3111071,46,50,-4
2022,3,3111072,226,218,8
2022,3,3111073,363,360,3
2022,3,3111074,101,105,-4
2022,3,3111075,140,139,1
2022,3,3111076,159,161,-2
2022,3,3111077,561,568,-7
2022,3,3111078,545,534,11
2022,3,3111079,88,87,1
2022,3,3111080,202,202,0
2022,3,3111082,29,25,4
2022,3,3111083,184,182,2
2022,3,3111084,40,42,-2
2022,3,3111085,280,277,3
2022,3,3111086,226,215,11
2022,3,3111087,108,98,10
2022,3,3111088,165,166,-1
2022,3,3111089,423,428,-5
2022,4,3110001,42,42,0
2022,4,3110002,101,99,2
2022,4,3110003,132,134,-2
2022,4,3110004,30,30,0
2022,4,3110005,88,86,2
2022,4,3110006,24,23,1
2022,4,3110007,76,75,1
2022,4,3110008,251,253,-2
2022,4,3110009,107,104,3
2022,4,3110010,188,194,-6
2022,4,3110012,611,638,-27
2022,4,3110014,46,45,1
2022,4,3110016,110,118,-8
2022,4,3110017,52,53,-1
2022,4,3110018,158,152,6
2022,4,3110020,117,107,10
2022,4,3110021,131,131,0
2022,4,3110022,108,110,-2
2022,4,3110023,47,44,3
2022,4,3110024,116,118,-2
2022,4,3110025,61,62,-1
2022,4,3110027,67,63,4
2022,4,3110028,209,215,-6
2022,4,3110029,176,188,-12
2022,4,3110030,34,38,-4
2022,4,3110031,62,62,0
2022,4,3110033,111,115,-4
2022,4,3110035,154,159,-5
2022,4,3110036,61,61,0
2022,4,3110037,119,122,-3
2022,4,3110039,22,25,-3
2022,4,3110040,116,127,-11
2022,4,3110041,145,155,-10
2022,4,3110042,70,72,-2
2022,4,3110043,224,223,1
2022,4,3110045,109,114,-5
2022,4,3110047,59,60,-1
2022,4,3110048,153,162,-9
2022,4,3110049,156,162,-6
2022,4,3110050,53,56,-3
2022,4,3110051,74,78,-4
2022,4,3110052,188,190,-2
2022,4,3110053,221,226,-5
2022,4,3110054,273,295,-22
2022,4,3110055,107,110,-3
2022,4,3110056,421,428,-7
2022,4,3110057,147,163,-16
2022,4,3110058,281,287,-6
2022,4,3110059,134,139,-5
2022,4,3110060,174,182,-8
2022,4,3110061,114,121,-7
2022,4,3110062,267,246,21
2022,4,3110063,281,279,2
2022,4,3110064,184,191,-7
2022,4,3110065,66,65,1
2022,4,3110066,203,207,-4
2022,4,3110067,207,205,2
2022,4,3110068,321,322,-1
2022,4,3110069,493,504,-11
2022,4,3110070,38,37,1
2022,4,3110071,79,83,-4
2022,4,3110073,101,93,8
2022,4,3110074,232,224,8
2022,4,3110075,139,144,-5
2022,4,3110077,84,86,-2
2022,4,3110078,86,89,-3
2022,4,3110079,380,390,-10
2022,4,3110080,172,172,0
2022,4,3110081,262,247,15
2022,4,3110082,159,154,5
2022,4,3110083,83,86,-3
2022,4,3110084,399,378,21
2022,4,3110085,354,345,9
2022,4,3110087,127,129,-2
2022,4,3110088,91,93,-2
2022,4,3110089,64,64,0
2022,4,3110090,120,128,-8
2022,4,3110092,156,157,-1
2022,4,3110093,392,407,-15
2022,4,3110095,262,249,13
2022,4,3110096,71,68,3
2022,4,3110098,76,76,0
2022,4,3110099,104,100,4
2022,4,3110102,169,165,4
2022,4,3110103,36,39,-3
2022,4,3110104,103,105,-2
2022,4,3110105,140,139,1
2022,4,3110107,54,50,4
2022,4,3110109,142,142,0
2022,4,3110110,102,109,-7
2022,4,3110112,132,133,-1
2022,4,3110113,62,60,2
2022,4,3110114,124,136,-12
2022,4,3110115,205,203,2
2022,4,3110116,213,212,1
2022,4,3110117,83,87,-4
2022,4,3110118,175,175,0
2022,4,3110120,130,106,24
2022,4,3110121,74,79,-5
2022,4,3110122,217,221,-4
2022,4,3110123,164,164,0
2022,4,3110124,193,195,-2
2022,4,3110125,129,134,-5
2022,4,3110126,34,31,3
2022,4,3110127,136,136,0
2022,4,3110128,519,538,-19
2022,4,3110129,180,163,17
2022,4,3110130,46,47,-1
2022,4,3110131,471,456,15
2022,4,3110132,136,126,10
2022,4,3110133,87,93,-6
2022,4,3110134,331,339,-8
2022,4,3110135,170,175,-5
2022,4,3110136,469,448,21
2022,4,3110137,688,691,-3
2022,4,3110138,169,173,-4
2022,4,3110139,289,288,1
2022,4,3110140,385,378,7
2022,4,3110141,123,128,-5
2022,4,3110142,274,274,0
2022,4,3110144,66,69,-3
2022,4,3110146,197,202,-5
2022,4,3110147,245,248,-3
2022,4,3110148,81,86,-5
2022,4,3110149,55,52,3
2022,4,3110150,256,267,-11
2022,4,3110151,253,254,-1
2022,4,3110152,98,103,-5
2022,4,3110153,69,66,3
2022,4,3110154,265,271,-6
2022,4,3110155,169,170,-1
2022,4,3110156,195,197,-2
2022,4,3110157,244,244,0
2022,4,3110158,344,350,-6
2022,4,3110159,446,460,-14
2022,4,3110160,54,56,-2
2022,4,3110161,295,310,-15
2022,4,3110162,148,150,-2
2022,4,3110163,203,204,-1
2022,4,3110164,93,95,-2
2022,4,3110165,182,179,3
2022,4,3110166,348,349,-1
2022,4,3110167,310,312,-2
2022,4,3110168,108,111,-3
2022,4,3110169,135,141,-6
2022,4,3110170,252,261,-9
2022,4,3110171,34,38,-4
2022,4,3110172,163,155,8
2022,4,3110173,88,93,-5
2022,4,3110174,231,235,-4
2022,4,3110175,162,167,-5
2022,4,3110176,228,227,1
2022,4,3110177,42,43,-1
2022,4,3110178,62,60,2
2022,4,3110179,116,114,2
2022,4,3110180,235,236,-1
2022,4,3110181,239,242,-3
2022,4,3110182,103,108,-5
2022,4,3110183,109,111,-2
2022,4,3110184,45,43,2
2022,4,3110185,48,49,-1
2022,4,3110186,61,61,0
2022,4,3110187,387,400,-13
2022,4,3110188,222,232,-10
2022,4,3110189,106,113,-7
2022,4,3110190,103,108,-5
2022,4,3110191,158,154,4
2022,4,3110193,89,90,-1
2022,4,3110194,132,138,-6
2022,4,3110195,227,249,-22
2022,4,3110197,35,34,1
2022,4,3110199,162,168,-6
2022,4,3110200,43,43,0
2022,4,3110201,39,40,-1
2022,4,3110203,84,81,3
2022,4,3110204,260,263,-3
2022,4,3110205,258,254,4
2022,4,3110206,178,171,7
2022,4,3110207,73,80,-7
2022,4,3110208,51,53,-2
2022,4,3110209,60,66,-6
2022,4,3110210,161,157,4
2022,4,3110211,218,219,-1
2022,4,3110212,237,232,5
2022,4,3110213,37,38,-1
2022,4,3110214,102,106,-4
2022,4,3110215,66,71,-5
2022,4,3110216,156,148,8
2022,4,3110217,415,419,-4
2022,4,3110218,194,208,-14
2022,4,3110219,278,282,-4
2022,4,3110220,358,351,7
2022,4,3110221,56,52,4
2022,4,3110224,86,85,1
2022,4,3110225,161,162,-1
2022,4,3110226,767,794,-27
2022,4,3110227,132,138,-6
2022,4,3110228,341,335,6
2022,4,3110229,370,379,-9
2022,4,3110230,172,180,-8
2022,4,3110232,274,286,-12
2022,4,3110233,155,155,0
2022,4,3110234,62,68,-6
2022,4,3110236,333,347,-14
2022,4,3110237,304,307,-3
2022,4,3110238,43,45,-2
2022,4,3110240,149,145,4
2022,4,3110241,315,320,-5
2022,4,3110242,154,156,-2
2022,4,3110243,287,293,-6
2022,4,3110244,192,189,3
2022,4,3110245,58,57,1
2022,4,3110246,202,213,-11
2022,4,3110247,284,278,6
2022,4,3110248,46,51,-5
2022,4,3110249,289,311,-22
2022,4,3110250,79,74,5
2022,4,3110251,190,184,6
2022,4,3110252,224,229,-5
2022,4,3110253,197,193,4
2022,4,3110254,347,354,-7
2022,4,3110255,325,327,-2
2022,4,3110256,307,308,-1
2022,4,3110257,121,122,-1
2022,4,3110258,201,207,-6
2022,4,3110259,229,229,0
2022,4,3110260,169,168,1
2022,4,3110261,179,179,0
2022,4,3110262,325,324,1
2022,4,3110263,199,211,-12
2022,4,3110264,391,406,-15
2022,4,3110265,142,143,-1
2022,4,3110266,195,207,-12
2022,4,3110267,218,219,-1
2022,4,3110268,92,89,3
2022,4,3110269,86,88,-2
2022,4,3110270,68,70,-2
2022,4,3110271,34,34,0
2022,4,3110272,392,406,-14
2022,4,3110273,143,131,12
2022,4,3110274,272,286,-14
2022,4,3110275,93,89,4
2022,4,3110276,28,28,0
2022,4,3110277,196,197,-1
2022,4,3110278,290,303,-13
2022,4,3110280,38,41,-3
2022,4,3110281,52,50,2
2022,4,3110282,64,63,1
2022,4,3110283,76,75,1
2022,4,3110284,46,46,0
2022,4,3110285,91,94,-3
2022,4,3110286,166,173,-7
2022,4,3110287,51,50,1
2022,4,3110288,109,116,-7
2022,4,3110289,121,125,-4
2022,4,3110290,41,45,-4
2022,4,3110291,232,229,3
2022,4,3110292,43,45,-2
2022,4,3110293,202,197,5
2022,4,3110294,190,191,-1
2022,4,3110295,169,178,-9
2022,4,3110296,184,187,-3
2022,4,3110297,233,239,-6
2022,4,3110298,45,44,1
2022,4,3110299,295,288,7
2022,4,3110300,305,309,-4
2022,4,3110301,145,147,-2
2022,4,3110302,171,174,-3
2022,4,3110303,168,170,-2
2022,4,3110304,142,132,10
2022,4,3110305,244,250,-6
2022,4,3110306,90,93,-3
2022,4,3110307,144,146,-2
2022,4,3110308,187,189,-2
2022,4,3110309,95,94,1
2022,4,3110310,22,23,-1
2022,4,3110312,153,152,1
2022,4,3110313,315,318,-3
2022,4,3110314,260,265,-5
2022,4,3110315,208,218,-10
2022,4,3110316,376,379,-3
2022,4,3110317,128,130,-2
2022,4,3110318,83,90,-7
2022,4,3110319,229,237,-8
2022,4,3110320,53,56,-3
2022,4,3110322,81,83,-2
2022,4,3110323,180,176,4
2022,4,3110325,148,148,0
2022,4,3110326,34,36,-2
2022,4,3110327,150,158,-8
2022,4,3110328,84,89,-5
2022,4,3110329,98,98,0
2022,4,3110330,119,121,-2
2022,4,3110331,192,191,1
2022,4,3110332,65,67,-2
2022,4,3110333,186,188,-2
2022,4,3110334,140,137,3
2022,4,3110335,293,301,-8
2022,4,3110336,65,67,-2
2022,4,3110337,87,100,-13
2022,4,3110340,54,55,-1
2022,4,3110341,94,92,2
2022,4,3110342,54,59,-5
2022,4,3110343,116,116,0
2022,4,3110344,23,23,0
2022,4,3110345,139,134,5
2022,4,3110346,85,84,1
2022,4,3110348,149,151,-2
2022,4,3110349,30,31,-1
2022,4,3110350,92,94,-2
2022,4,3110351,109,114,-5
2022,4,3110352,189,193,-4
2022,4,3110353,114,120,-6
2022,4,3110354,74,75,-1
2022,4,3110355,128,128,0
2022,4,3110356,108,109,-1
2022,4,3110357,112,116,-4
2022,4,3110358,146,153,-7
2022,4,3110359,174,174,0
2022,4,3110360,205,218,-13
2022,4,3110361,83,93,-10
2022,4,3110362,197,201,-4
2022,4,3110363,43,44,-1
2022,4,3110364,180,190,-10
2022,4,3110365,138,143,-5
2022,4,3110366,122,125,-3
2022,4,3110367,152,152,0
2022,4,3110368,148,157,-9
2022,4,3110369,303,309,-6
2022,4,3110370,166,166,0
2022,4,3110371,141,137,4
2022,4,3110372,133,130,3
2022,4,3110373,179,181,-2
2022,4,3110374,346,357,-11
2022,4,3110375,72,73,-1
2022,4,3110376,344,361,-17
2022,4,3110377,93,97,-4
2022,4,3110378,113,113,0
2022,4,3110379,46,47,-1
2022,4,3110380,28,29,-1
2022,4,3110381,52,54,-2
2022,4,3110382,62,61,1
2022,4,3110383,99,107,-8
2022,4,3110387,177,181,-4
2022,4,3110388,81,86,-5
2022,4,3110389,69,70,-1
2022,4,3110390,181,169,12
2022,4,3110391,121,126,-5
2022,4,3110392,68,66,2
2022,4,3110393,56,60,-4
2022,4,3110394,253,253,0
2022,4,3110395,115,118,-3
2022,4,3110396,213,214,-1
2022,4,3110397,390,399,-9
2022,4,3110398,238,243,-5
2022,4,3110399,265,272,-7
2022,4,3110400,253,269,-16
2022,4,3110401,62,63,-1
2022,4,3110402,184,176,8
2022,4,3110403,343,351,-8
2022,4,3110404,434,435,-1
2022,4,3110405,423,422,1
2022,4,3110406,131,131,0
2022,4,3110407,333,348,-15
2022,4,3110408,105,109,-4
2022,4,3110409,262,270,-8
2022,4,3110410,272,275,-3
2022,4,3110411,124,122,2
2022,4,3110412,23,23,0
2022,4,3110413,83,82,1
2022,4,3110415,485,501,-16
2022,4,3110416,171,185,-14
2022,4,3110417,43,42,1
2022,4,3110418,70,71,-1
2022,4,3110419,355,366,-11
2022,4,3110420,163,165,-2
2022,4,3110421,219,222,-3
2022,4,3110422,103,106,-3
2022,4,3110423,143,144,-1
2022,4,3110424,257,258,-1
2022,4,3110425,260,265,-5
2022,4,3110426,259,258,1
2022,4,3110427,46,46,0
2022,4,3110428,436,448,-12
2022,4,3110429,430,435,-5
2022,4,3110431,365,367,-2
2022,4,3110432,131,136,-5
2022,4,3110433,216,217,-1
2022,4,3110434,105,101,4
2022,4,3110435,82,85,-3
2022,4,3110436,75,76,-1
2022,4,3110437,132,137,-5
2022,4,3110438,333,336,-3
2022,4,3110439,134,142,-8
2022,4,3110440,67,75,-8
2022,4,3110441,174,173,1
2022,4,3110442,49,48,1
2022,4,3110443,51,49,2
2022,4,3110444,20,21,-1
2022,4,3110446,61,71,-10
2022,4,3110447,40,41,-1
2022,4,3110448,79,83,-4
2022,4,3110449,221,225,-4
2022,4,3110450,355,369,-14
2022,4,3110451,248,257,-9
2022,4,3110452,178,188,-10
2022,4,3110453,305,313,-8
2022,4,3110454,143,146,-3
2022,4,3110455,293,298,-5
2022,4,3110456,332,350,-18
2022,4,3110457,123,130,-7
2022,4,3110458,238,243,-5
2022,4,3110459,238,243,-5
2022,4,3110460,330,320,10
2022,4,3110461,69,71,-2
2022,4,3110462,140,161,-21
2022,4,3110463,98,102,-4
2022,4,3110464,204,202,2
2022,4,3110465,219,227,-8
2022,4,3110466,144,144,0
2022,4,3110467,192,195,-3
2022,4,3110468,453,467,-14
2022,4,3110469,433,442,-9
2022,4,3110470,118,116,2
2022,4,3110471,205,212,-7
2022,4,3110472,294,293,1
2022,4,3110473,356,356,0
2022,4,3110474,129,139,-10
2022,4,3110475,133,130,3
2022,4,3110476,64,61,3
2022,4,3110477,226,235,-9
2022,4,3110478,149,151,-2
2022,4,3110479,178,179,-1
2022,4,3110480,98,102,-4
2022,4,3110481,279,298,-19
2022,4,3110482,49,56,-7
2022,4,3110483,63,69,-6
2022,4,3110484,182,196,-14
2022,4,3110485,132,127,5
2022,4,3110486,194,198,-4
2022,4,3110487,69,71,-2
2022,4,3110488,172,184,-12
2022,4,3110489,74,70,4
2022,4,3110490,119,119,0
2022,4,3110491,39,40,-1
2022,4,3110493,85,83,2
2022,4,3110495,250,256,-6
2022,4,3110496,221,221,0
2022,4,3110498,122,123,-1
2022,4,3110499,141,146,-5
2022,4,3110500,53,51,2
2022,4,3110501,59,63,-4
2022,4,3110502,284,284,0
2022,4,3110503,341,340,1
2022,4,3110505,18,19,-1
2022,4,3110506,42,44,-2
2022,4,3110507,439,441,-2
2022,4,3110508,137,131,6
2022,4,3110509,350,372,-22
2022,4,3110510,76,78,-2
2022,4,3110511,133,135,-2
2022,4,3110512,97,101,-4
2022,4,3110513,107,103,4
2022,4,3110514,51,55,-4
2022,4,3110515,44,53,-9
2022,4,3110517,72,75,-3
2022,4,3110519,101,106,-5
2022,4,3110520,87,90,-3
2022,4,3110521,81,81,0
2022,4,3110522,52,51,1
2022,4,3110523,19,22,-3
2022,4,3110524,50,49,1
2022,4,3110525,141,145,-4
2022,4,3110526,36,38,-2
2022,4,3110527,136,126,10
2022,4,3110528,113,115,-2
2022,4,3110529,215,218,-3
2022,4,3110532,122,125,-3
2022,4,3110533,25,24,1
2022,4,3110534,51,52,-1
2022,4,3110535,63,58,5
2022,4,3110536,44,43,1
2022,4,3110537,154,160,-6
2022,4,3110538,71,72,-1
2022,4,3110539,89,91,-2
2022,4,3110540,88,89,-1
2022,4,3110541,280,280,0
2022,4,3110542,304,311,-7
2022,4,3110543,31,29,2
2022,4,3110544,1097,1084,13
2022,4,3110545,271,263,8
2022,4,3110546,88,88,0
2022,4,3110547,258,264,-6
2022,4,3110548,172,172,0
2022,4,3110549,119,123,-4
2022,4,3110550,412,419,-7
2022,4,3110551,199,203,-4
2022,4,3110552,139,139,0
2022,4,3110553,172,173,-1
2022,4,3110554,264,267,-3
2022,4,3110555,71,75,-4
2022,4,3110557,294,296,-2
2022,4,3110558,433,440,-7
2022,4,3110559,458,459,-1
2022,4,3110560,122,115,7
2022,4,3110561,165,169,-4
2022,4,3110562,285,274,11
2022,4,3110563,55,55,0
2022,4,3110564,238,221,17
2022,4,3110565,84,86,-2
2022,4,3110566,545,526,19
2022,4,3110567,83,87,-4
2022,4,3110568,81,84,-3
2022,4,3110569,314,309,5
2022,4,3110570,71,70,1
2022,4,3110571,129,140,-11
2022,4,3110572,273,266,7
2022,4,3110573,30,31,-1
2022,4,3110574,49,49,0
2022,4,3110575,70,67,3
2022,4,3110576,234,226,8
2022,4,3110577,132,124,8
2022,4,3110578,312,325,-13
2022,4,3110579,79,77,2
2022,4,3110580,66,61,5
2022,4,3110582,168,169,-1
2022,4,3110583,49,47,2
2022,4,3110584,67,69,-2
2022,4,3110585,48,49,-1
2022,4,3110586,340,347,-7
2022,4,3110587,144,147,-3
2022,4,3110588,90,99,-9
2022,4,3110589,41,38,3
2022,4,3110590,132,133,-1
2022,4,3110591,87,94,-7
2022,4,3110592,61,60,1
2022,4,3110593,245,255,-10
2022,4,3110594,116,118,-2
2022,4,3110595,276,289,-13
2022,4,3110596,111,106,5
2022,4,3110597,239,256,-17
2022,4,3110598,223,235,-12
2022,4,3110599,194,196,-2
2022,4,3110600,187,197,-10
2022,4,3110601,271,283,-12
2022,4,3110602,101,104,-3
2022,4,3110603,88,81,7
2022,4,3110604,225,234,-9
2022,4,3110605,103,95,8
2022,4,3110606,283,290,-7
2022,4,3110607,61,58,3
2022,4,3110608,217,225,-8
2022,4,3110609,56,59,-3
2022,4,3110611,111,113,-2
2022,4,3110612,280,284,-4
2022,4,3110613,44,51,-7
2022,4,3110614,187,188,-1
2022,4,3110615,142,143,-1
2022,4,3110616,45,49,-4
2022,4,3110617,95,95,0
2022,4,3110618,225,233,-8
2022,4,3110619,85,87,-2
2022,4,3110620,371,391,-20
2022,4,3110621,72,74,-2
2022,4,3110622,167,169,-2
2022,4,3110624,59,59,0
2022,4,3110625,388,380,8
2022,4,3110626,185,190,-5
2022,4,3110627,261,259,2
2022,4,3110628,68,69,-1
2022,4,3110629,24,25,-1
2022,4,3110630,252,262,-10
2022,4,3110631,94,109,-15
2022,4,3110632,157,154,3
2022,4,3110633,89,90,-1
2022,4,3110634,443,457,-14
2022,4,3110635,149,142,7
2022,4,3110636,105,107,-2
2022,4,3110637,112,120,-8
2022,4,3110638,440,436,4
2022,4,3110639,104,110,-6
2022,4,3110640,165,172,-7
2022,4,3110641,105,103,2
2022,4,3110643,202,205,-3
2022,4,3110644,32,32,0
2022,4,3110645,369,370,-1
2022,4,3110646,419,408,11
2022,4,3110647,376,386,-10
2022,4,3110649,199,209,-10
2022,4,3110650,76,77,-1
2022,4,3110651,241,242,-1
2022,4,3110652,140,144,-4
2022,4,3110653,177,182,-5
2022,4,3110654,502,536,-34
2022,4,3110655,175,175,0
2022,4,3110656,496,510,-14
2022,4,3110657,386,393,-7
2022,4,3110658,155,156,-1
2022,4,3110659,515,519,-4
2022,4,3110660,563,564,-1
2022,4,3110661,48,49,-1
2022,4,3110662,344,354,-10
2022,4,3110663,99,104,-5
2022,4,3110664,73,74,-1
2022,4,3110665,302,313,-11
2022,4,3110666,42,42,0
2022,4,3110668,347,344,3
2022,4,3110670,165,164,1
2022,4,3110671,395,414,-19
2022,4,3110672,69,75,-6
2022,4,3110673,242,240,2
2022,4,3110675,187,199,-12
2022,4,3110676,84,87,-3
2022,4,3110677,69,69,0
2022,4,3110678,61,61,0
2022,4,3110679,70,63,7
2022,4,3110680,83,85,-2
2022,4,3110681,33,32,1
2022,4,3110683,26,29,-3
2022,4,3110684,79,82,-3
2022,4,3110686,183,193,-10
2022,4,3110687,35,39,-4
2022,4,3110688,90,93,-3
2022,4,3110689,155,156,-1
2022,4,3110690,381,383,-2
2022,4,3110691,165,169,-4
2022,4,3110692,65,71,-6
2022,4,3110693,21,25,-4
2022,4,3110694,270,269,1
2022,4,3110695,307,304,3
2022,4,3110696,69,73,-4
2022,4,3110697,92,95,-3
2022,4,3110698,120,130,-10
2022,4,3110699,131,127,4
2022,4,3110700,130,133,-3
2022,4,3110701,117,116,1
2022,4,3110702,103,107,-4
2022,4,3110703,210,213,-3
2022,4,3110706,182,185,-3
2022,4,3110707,137,143,-6
2022,4,3110708,60,62,-2
2022,4,3110709,116,127,-11
2022,4,3110710,427,441,-14
2022,4,3110711,287,286,1
2022,4,3110712,269,277,-8
2022,4,3110713,514,530,-16
2022,4,3110714,376,375,1
2022,4,3110715,44,43,1
2022,4,3110716,169,163,6
2022,4,3110717,421,442,-21
2022,4,3110718,271,271,0
2022,4,3110719,37,36,1
2022,4,3110720,237,238,-1
2022,4,3110721,133,146,-13
2022,4,3110722,132,135,-3
2022,4,3110723,77,79,-2
2022,4,3110724,102,109,-7
2022,4,3110725,148,141,7
2022,4,3110726,94,96,-2
2022,4,3110727,69,75,-6
2022,4,3110728,76,78,-2
2022,4,3110729,207,216,-9
2022,4,3110730,159,209,-50
2022,4,3110731,201,202,-1
2022,4,3110732,217,223,-6
2022,4,3110733,49,54,-5
2022,4,3110734,21,21,0
2022,4,3110735,215,224,-9
2022,4,3110736,232,238,-6
2022,4,3110737,135,142,-7
2022,4,3110738,316,312,4
2022,4,3110739,20,22,-2
2022,4,3110740,150,153,-3
2022,4,3110741,199,202,-3
2022,4,3110742,133,130,3
2022,4,3110743,217,219,-2
2022,4,3110744,325,328,-3
2022,4,3110745,170,167,3
2022,4,3110746,115,118,-3
2022,4,3110747,95,94,1
2022,4,3110748,105,108,-3
2022,4,3110749,203,211,-8
2022,4,3110750,171,174,-3
2022,4,3110751,151,155,-4
2022,4,3110752,240,252,-12
2022,4,3110753,238,242,-4
2022,4,3110754,166,166,0
2022,4,3110755,165,171,-6
2022,4,3110756,116,121,-5
2022,4,3110757,237,242,-5
2022,4,3110758,40,42,-2
2022,4,3110760,222,229,-7
2022,4,3110762,621,647,-26
2022,4,3110765,97,103,-6
2022,4,3110766,205,208,-3
2022,4,3110767,20,19,1
2022,4,3110768,85,88,-3
2022,4,3110769,81,86,-5
2022,4,3110770,173,172,1
2022,4,3110771,50,50,0
2022,4,3110772,36,36,0
2022,4,3110774,130,130,0
2022,4,3110775,102,105,-3
2022,4,3110776,148,158,-10
2022,4,3110777,65,68,-3
2022,4,3110778,372,378,-6
2022,4,3110780,79,83,-4
2022,4,3110781,133,133,0
2022,4,3110782,74,75,-1
2022,4,3110783,128,129,-1
2022,4,3110784,53,56,-3
2022,4,3110785,182,175,7
2022,4,3110786,75,77,-2
2022,4,3110787,198,200,-2
2022,4,3110788,42,45,-3
2022,4,3110789,196,198,-2
2022,4,3110790,173,187,-14
2022,4,3110791,36,34,2
2022,4,3110792,211,215,-4
2022,4,3110794,164,176,-12
2022,4,3110795,53,56,-3
2022,4,3110796,40,45,-5
2022,4,3110798,31,33,-2
2022,4,3110799,29,31,-2
2022,4,3110800,40,44,-4
2022,4,3110802,111,114,-3
2022,4,3110803,160,168,-8
2022,4,3110804,139,137,2
2022,4,3110805,53,51,2
2022,4,3110807,89,84,5
2022,4,3110809,69,71,-2
2022,4,3110810,267,272,-5
2022,4,3110811,94,93,1
2022,4,3110812,109,112,-3
2022,4,3110813,290,292,-2
2022,4,3110814,182,187,-5
2022,4,3110815,246,259,-13
2022,4,3110816,94,95,-1
2022,4,3110817,37,44,-7
2022,4,3110818,30,36,-6
2022,4,3110819,298,295,3
2022,4,3110820,205,194,11
2022,4,3110821,157,164,-7
2022,4,3110822,61,70,-9
2022,4,3110823,102,106,-4
2022,4,3110824,82,78,4
2022,4,3110825,225,234,-9
2022,4,3110826,217,224,-7
2022,4,3110827,131,135,-4
2022,4,3110828,293,307,-14
2022,4,3110829,65,78,-13
2022,4,3110830,92,94,-2
2022,4,3110831,101,103,-2
2022,4,3110832,127,128,-1
2022,4,3110833,132,128,4
2022,4,3110835,80,80,0
2022,4,3110836,469,482,-13
2022,4,3110837,246,243,3
2022,4,3110838,56,55,1
2022,4,3110839,212,213,-1
2022,4,3110840,197,197,0
2022,4,3110841,32,48,-16
2022,4,3110842,154,155,-1
2022,4,3110843,83,86,-3
2022,4,3110845,48,46,2
2022,4,3110846,378,385,-7
2022,4,3110847,70,77,-7
2022,4,3110848,188,181,7
2022,4,3110849,174,184,-10
2022,4,3110850,482,476,6
2022,4,3110851,101,105,-4
2022,4,3110852,120,117,3
2022,4,3110853,87,91,-4
2022,4,3110854,70,67,3
2022,4,3110855,384,409,-25
2022,4,3110856,237,237,0
2022,4,3110857,151,155,-4
2022,4,3110858,83,83,0
2022,4,3110859,79,76,3
2022,4,3110860,116,116,0
2022,4,3110861,463,488,-25
2022,4,3110862,92,95,-3
2022,4,3110863,187,189,-2
2022,4,3110864,113,127,-14
2022,4,3110865,334,340,-6
2022,4,3110866,144,148,-4
2022,4,3110867,134,138,-4
2022,4,3110868,146,143,3
2022,4,3110869,411,428,-17
2022,4,3110871,162,161,1
2022,4,3110872,57,59,-2
2022,4,3110873,278,284,-6
2022,4,3110874,99,114,-15
2022,4,3110875,74,85,-11
2022,4,3110876,135,145,-10
2022,4,3110877,206,217,-11
2022,4,3110878,41,40,1
2022,4,3110879,85,87,-2
2022,4,3110880,50,50,0
2022,4,3110881,629,646,-17
2022,4,3110882,228,232,-4
2022,4,3110883,252,256,-4
2022,4,3110884,114,122,-8
2022,4,3110885,203,203,0
2022,4,3110886,125,130,-5
2022,4,3110887,46,47,-1
2022,4,3110888,139,134,5
2022,4,3110889,69,67,2
2022,4,3110890,152,156,-4
2022,4,3110891,135,135,0
2022,4,3110892,530,540,-10
2022,4,3110893,25,26,-1
2022,4,3110895,559,570,-11
2022,4,3110896,121,122,-1
2022,4,3110897,203,200,3
2022,4,3110899,68,75,-7
2022,4,3110900,179,188,-9
2022,4,3110901,132,134,-2
2022,4,3110902,374,377,-3
2022,4,3110903,225,226,-1
2022,4,3110904,167,165,2
2022,4,3110905,99,100,-1
2022,4,3110906,56,65,-9
2022,4,3110907,302,295,7
2022,4,3110908,218,234,-16
2022,4,3110910,74,78,-4
2022,4,3110912,129,128,1
2022,4,3110913,159,175,-16
2022,4,3110915,90,93,-3
2022,4,3110916,174,173,1
2022,4,3110917,44,43,1
2022,4,3110918,124,121,3
2022,4,3110919,106,104,2
2022,4,3110921,59,56,3
2022,4,3110922,67,68,-1
2022,4,3110924,86,86,0
2022,4,3110925,121,116,5
2022,4,3110926,143,146,-3
2022,4,3110929,209,204,5
2022,4,3110930,93,93,0
2022,4,3110931,34,31,3
2022,4,3110932,54,56,-2
2022,4,3110934,208,222,-14
2022,4,3110935,71,73,-2
2022,4,3110936,84,86,-2
2022,4,3110939,602,618,-16
2022,4,3110940,71,74,-3
2022,4,3110942,452,456,-4
2022,4,3110943,168,172,-4
2022,4,3110945,19,19,0
2022,4,3110947,23,24,-1
2022,4,3110949,152,145,7
2022,4,3110951,95,90,5
2022,4,3110952,37,42,-5
2022,4,3110953,87,91,-4
2022,4,3110954,40,40,0
2022,4,3110955,439,436,3
2022,4,3110956,56,57,-1
2022,4,3110957,338,353,-15
2022,4,3110958,107,124,-17
2022,4,3110959,35,30,5
2022,4,3110961,165,168,-3
2022,4,3110966,336,336,0
2022,4,3110967,128,127,1
2022,4,3110968,58,62,-4
2022,4,3110969,86,88,-2
2022,4,3110970,65,63,2
2022,4,3110971,172,182,-10
2022,4,3110972,63,58,5
2022,4,3110973,163,167,-4
2022,4,3110974,69,67,2
2022,4,3110975,50,51,-1
2022,4,3110976,179,178,1
2022,4,3110979,59,58,1
2022,4,3110980,108,106,2
2022,4,3110981,200,201,-1
2022,4,3110982,88,87,1
2022,4,3110983,110,104,6
2022,4,3110984,317,311,6
2022,4,3110988,63,60,3
2022,4,3110989,106,113,-7
2022,4,3110992,383,387,-4
2022,4,3110994,245,234,11
2022,4,3110995,100,106,-6
2022,4,3110996,109,113,-4
2022,4,3110997,619,627,-8
2022,4,3110999,119,103,16
2022,4,3111001,62,60,2
2022,4,3111003,563,568,-5
2022,4,3111004,645,668,-23
2022,4,3111005,307,315,-8
2022,4,3111006,457,481,-24
2022,4,3111007,248,261,-13
2022,4,3111008,238,237,1
2022,4,3111009,96,98,-2
2022,4,3111010,438,443,-5
2022,4,3111011,108,105,3
2022,4,3111012,276,285,-9
2022,4,3111013,591,579,12
2022,4,3111014,161,163,-2
2022,4,3111015,423,429,-6
2022,4,3111016,166,172,-6
2022,4,3111017,69,72,-3
2022,4,3111019,310,327,-17
2022,4,3111020,142,139,3
2022,4,3111021,697,700,-3
2022,4,3111022,98,98,0
2022,4,3111023,155,152,3
2022,4,3111024,78,79,-1
2022,4,3111025,123,127,-4
2022,4,3111026,287,287,0
2022,4,3111027,320,315,5
2022,4,3111028,167,161,6
2022,4,3111029,90,95,-5
2022,4,3111030,180,185,-5
2022,4,3111031,149,152,-3
2022,4,3111032,198,202,-4
2022,4,3111033,60,61,-1
2022,4,3111034,230,232,-2
2022,4,3111035,129,135,-6
2022,4,3111036,59,62,-3
2022,4,3111037,45,46,-1
2022,4,3111038,166,162,4
2022,4,3111039,135,142,-7
2022,4,3111040,66,64,2
2022,4,3111042,282,290,-8
2022,4,3111043,60,61,-1
2022,4,3111044,279,277,2
2022,4,3111045,44,43,1
2022,4,3111046,494,501,-7
2022,4,3111047,80,80,0
2022,4,3111049,208,224,-16
2022,4,3111051,322,315,7
2022,4,3111052,287,301,-14
2022,4,3111053,246,255,-9
2022,4,3111054,50,48,2
2022,4,3111055,29,30,-1
2022,4,3111056,93,91,2
2022,4,3111057,227,229,-2
2022,4,3111058,84,84,0
2022,4,3111059,617,624,-7
2022,4,3111060,507,530,-23
2022,4,3111061,349,364,-15
2022,4,3111062,171,171,0
2022,4,3111063,217,220,-3
2022,4,3111064,146,142,4
2022,4,3111065,67,75,-8
2022,4,3111066,206,218,-12
2022,4,3111067,341,356,-15
2022,4,3111068,33,39,-6
2022,4,3111069,136,133,3
2022,4,3111070,71,81,-10
2022,4,3111071,46,52,-6
2022,4,3111072,231,232,-1
2022,4,3111073,361,360,1
2022,4,3111074,99,107,-8
2022,4,3111075,141,145,-4
2022,4,3111076,158,164,-6
2022,4,3111077,555,575,-20
2022,4,3111078,539,552,-13
2022,4,3111079,88,91,-3
2022,4,3111080,201,202,-1
2022,4,3111082,30,27,3
2022,4,3111083,182,184,-2
2022,4,3111084,40,43,-3
2022,4,3111085,275,278,-3
2022,4,3111086,224,218,6
2022,4,3111087,110,104,6
2022,4,3111088,167,165,2
2022,4,3111089,419,430,-11
2023,1,3110001,40,42,-2
2023,1,3110002,97,101,-4
2023,1,3110003,134,136,-2
2023,1,3110004,30,29,1
2023,1,3110005,85,86,-1
2023,1,3110006,23,23,0
2023,1,3110007,72,73,-1
2023,1,3110008,252,252,0
2023,1,3110009,103,105,-2
2023,1,3110010,191,189,2
2023,1,3110012,602,632,-30
2023,1,3110014,45,45,0
2023,1,3110016,111,115,-4
2023,1,3110017,53,53,0
2023,1,3110018,163,155,8
2023,1,3110020,114,114,0
2023,1,3110021,132,133,-1
2023,1,3110022,105,106,-1
2023,1,3110023,46,46,0
2023,1,3110024,113,119,-6
2023,1,3110025,60,63,-3
2023,1,3110027,67,63,4
2023,1,3110028,205,214,-9
2023,1,3110029,173,186,-13
2023,1,3110030,33,37,-4
2023,1,3110031,62,63,-1
2023,1,3110033,107,115,-8
2023,1,3110035,154,158,-4
2023,1,3110036,59,62,-3
2023,1,3110037,112,120,-8
2023,1,3110039,22,25,-3
2023,1,3110040,116,119,-3
2023,1,3110041,142,152,-10
2023,1,3110042,71,72,-1
2023,1,3110043,221,222,-1
2023,1,3110045,107,111,-4
2023,1,3110047,55,62,-7
2023,1,3110048,154,161,-7
2023,1,3110049,147,159,-12
2023,1,3110050,51,55,-4
2023,1,3110051,72,77,-5
2023,1,3110052,187,193,-6
2023,1,3110053,213,228,-15
2023,1,3110054,263,287,-24
2023,1,3110055,105,110,-5
2023,1,3110056,414,423,-9
2023,1,3110057,141,157,-16
2023,1,3110058,277,287,-10
2023,1,3110059,134,138,-4
2023,1,3110060,175,178,-3
2023,1,3110061,110,119,-9
2023,1,3110062,268,251,17
2023,1,3110063,276,283,-7
2023,1,3110064,186,189,-3
2023,1,3110065,66,65,1
2023,1,3110066,202,204,-2
2023,1,3110067,198,204,-6
2023,1,3110068,318,319,-1
2023,1,3110069,483,499,-16
2023,1,3110070,37,37,0
2023,1,3110071,78,81,-3
2023,1,3110073,101,94,7
2023,1,3110074,232,229,3
2023,1,3110075,140,142,-2
2023,1,3110077,84,86,-2
2023,1,3110078,85,88,-3
2023,1,3110079,376,382,-6
2023,1,3110080,173,169,4
2023,1,3110081,257,249,8
2023,1,3110082,165,156,9
2023,1,3110083,80,86,-6
2023,1,3110084,393,373,20
2023,1,3110085,345,350,-5
2023,1,3110087,128,130,-2
2023,1,3110088,92,93,-1
2023,1,3110089,63,64,-1
2023,1,3110090,117,128,-11
2023,1,3110092,148,157,-9
2023,1,3110093,373,401,-28
2023,1,3110095,268,248,20
2023,1,3110096,72,67,5
2023,1,3110098,77,76,1
2023,1,3110099,107,102,5
2023,1,3110102,171,171,0
2023,1,3110103,36,38,-2
2023,1,3110104,99,106,-7
2023,1,3110105,138,138,0
2023,1,3110107,53,50,3
2023,1,3110109,143,141,2
2023,1,3110110,106,107,-1
2023,1,3110112,133,134,-1
2023,1,3110113,59,62,-3
2023,1,3110114,119,133,-14
2023,1,3110115,197,204,-7
2023,1,3110116,206,213,-7
2023,1,3110117,80,86,-6
2023,1,3110118,173,175,-2
2023,1,3110120,133,110,23
2023,1,3110121,73,78,-5
2023,1,3110122,215,219,-4
2023,1,3110123,162,163,-1
2023,1,3110124,189,191,-2
2023,1,3110125,128,132,-4
2023,1,3110126,35,31,4
2023,1,3110127,132,137,-5
2023,1,3110128,519,533,-14
2023,1,3110129,183,162,21
2023,1,3110130,45,47,-2
2023,1,3110131,472,458,14
2023,1,3110132,135,130,5
2023,1,3110133,88,92,-4
2023,1,3110134,331,339,-8
2023,1,3110135,166,175,-9
2023,1,3110136,465,456,9
2023,1,3110137,682,689,-7
2023,1,3110138,174,170,4
2023,1,3110139,294,286,8
2023,1,3110140,379,382,-3
2023,1,3110141,122,128,-6
2023,1,3110142,270,275,-5
2023,1,3110144,68,68,0
2023,1,3110146,195,200,-5
2023,1,3110147,243,245,-2
2023,1,3110148,83,84,-1
2023,1,3110149,53,53,0
2023,1,3110150,252,261,-9
2023,1,3110151,251,255,-4
2023,1,3110152,98,103,-5
2023,1,3110153,71,66,5
2023,1,3110154,263,267,-4
2023,1,3110155,164,170,-6
2023,1,3110156,191,198,-7
2023,1,3110157,237,245,-8
2023,1,3110158,334,352,-18
2023,1,3110159,447,454,-7
2023,1,3110160,53,54,-1
2023,1,3110161,293,306,-13
2023,1,3110162,145,150,-5
2023,1,3110163,202,201,1
2023,1,3110164,90,95,-5
2023,1,3110165,177,178,-1
2023,1,3110166,352,347,5
2023,1,3110167,308,315,-7
2023,1,3110168,108,113,-5
2023,1,3110169,131,137,-6
2023,1,3110170,247,261,-14
2023,1,3110171,35,37,-2
2023,1,3110172,160,159,1
2023,1,3110173,88,91,-3
2023,1,3110174,229,232,-3
2023,1,3110175,160,169,-9
2023,1,3110176,223,228,-5
2023,1,3110177,43,46,-3
2023,1,3110178,63,60,3
2023,1,3110179,113,114,-1
2023,1,3110180,232,231,1
2023,1,3110181,238,240,-2
2023,1,3110182,103,105,-2
2023,1,3110183,108,111,-3
2023,1,3110184,45,44,1
2023,1,3110185,47,49,-2
2023,1,3110186,58,59,-1
2023,1,3110187,388,400,-12
2023,1,3110188,222,231,-9
2023,1,3110189,102,114,-12
2023,1,3110190,103,112,-9
2023,1,3110191,157,150,7
2023,1,3110193,89,90,-1
2023,1,3110194,132,138,-6
2023,1,3110195,223,244,-21
2023,1,3110197,35,34,1
2023,1,3110199,162,167,-5
2023,1,3110200,43,42,1
2023,1,3110201,39,40,-1
2023,1,3110203,84,83,1
2023,1,3110204,256,260,-4
2023,1,3110205,255,256,-1
2023,1,3110206,174,172,2
2023,1,3110207,74,80,-6
2023,1,3110208,52,52,0
2023,1,3110209,57,63,-6
2023,1,3110210,160,160,0
2023,1,3110211,214,217,-3
2023,1,3110212,244,229,15
2023,1,3110213,37,37,0
2023,1,3110214,99,107,-8
2023,1,3110215,66,71,-5
2023,1,3110216,155,149,6
2023,1,3110217,414,419,-5
2023,1,3110218,194,201,-7
2023,1,3110219,277,282,-5
2023,1,3110220,362,355,7
2023,1,3110221,54,53,1
2023,1,3110224,86,84,2
2023,1,3110225,160,163,-3
2023,1,3110226,755,789,-34
2023,1,3110227,134,139,-5
2023,1,3110228,336,336,0
2023,1,3110229,362,377,-15
2023,1,3110230,173,176,-3
2023,1,3110232,271,277,-6
2023,1,3110233,151,155,-4
2023,1,3110234,64,67,-3
2023,1,3110236,334,344,-10
2023,1,3110237,299,307,-8
2023,1,3110238,42,44,-2
2023,1,3110240,151,148,3
2023,1,3110241,313,318,-5
2023,1,3110242,151,159,-8
2023,1,3110243,288,290,-2
2023,1,3110244,188,187,1
2023,1,3110245,58,55,3
2023,1,3110246,198,214,-16
2023,1,3110247,283,277,6
2023,1,3110248,47,51,-4
2023,1,3110249,290,302,-12
2023,1,3110250,80,75,5
2023,1,3110251,188,185,3
2023,1,3110252,223,229,-6
2023,1,3110253,198,195,3
2023,1,3110254,337,352,-15
2023,1,3110255,319,327,-8
2023,1,3110256,306,309,-3
2023,1,3110257,123,118,5
2023,1,3110258,199,207,-8
2023,1,3110259,227,225,2
2023,1,3110260,169,170,-1
2023,1,3110261,181,182,-1
2023,1,3110262,321,328,-7
2023,1,3110263,193,207,-14
2023,1,3110264,390,402,-12
2023,1,3110265,136,141,-5
2023,1,3110266,186,202,-16
2023,1,3110267,212,220,-8
2023,1,3110268,92,89,3
2023,1,3110269,84,86,-2
2023,1,3110270,66,70,-4
2023,1,3110271,34,34,0
2023,1,3110272,397,405,-8
2023,1,3110273,144,132,12
2023,1,3110274,270,285,-15
2023,1,3110275,93,91,2
2023,1,3110276,29,28,1
2023,1,3110277,194,198,-4
2023,1,3110278,290,296,-6
2023,1,3110280,36,41,-5
2023,1,3110281,52,49,3
2023,1,3110282,62,64,-2
2023,1,3110283,75,75,0
2023,1,3110284,45,46,-1
2023,1,3110285,88,92,-4
2023,1,3110286,161,170,-9
2023,1,3110287,49,50,-1
2023,1,3110288,107,112,-5
2023,1,3110289,118,127,-9
2023,1,3110290,41,46,-5
2023,1,3110291,234,229,5
2023,1,3110292,43,45,-2
2023,1,3110293,196,198,-2
2023,1,3110294,189,192,-3
2023,1,3110295,169,174,-5
2023,1,3110296,180,185,-5
2023,1,3110297,227,236,-9
2023,1,3110298,44,44,0
2023,1,3110299,295,290,5
2023,1,3110300,301,310,-9
2023,1,3110301,140,143,-3
2023,1,3110302,172,174,-2
2023,1,3110303,163,170,-7
2023,1,3110304,143,136,7
2023,1,3110305,240,245,-5
2023,1,3110306,91,93,-2
2023,1,3110307,141,146,-5
2023,1,3110308,188,190,-2
2023,1,3110309,91,98,-7
2023,1,3110310,22,23,-1
2023,1,3110312,151,151,0
2023,1,3110313,316,316,0
2023,1,3110314,262,262,0
2023,1,3110315,204,217,-13
2023,1,3110316,371,372,-1
2023,1,3110317,125,131,-6
2023,1,3110318,83,86,-3
2023,1,3110319,232,233,-1
2023,1,3110320,53,54,-1
2023,1,3110322,82,83,-1
2023,1,3110323,182,178,4
2023,1,3110325,152,147,5
2023,1,3110326,34,36,-2
2023,1,3110327,146,155,-9
2023,1,3110328,84,88,-4
2023,1,3110329,97,98,-1
2023,1,3110330,114,122,-8
2023,1,3110331,194,193,1
2023,1,3110332,61,67,-6
2023,1,3110333,190,192,-2
2023,1,3110334,140,138,2
2023,1,3110335,289,303,-14
2023,1,3110336,63,67,-4
2023,1,3110337,87,97,-10
2023,1,3110340,54,55,-1
2023,1,3110341,94,92,2
2023,1,3110342,55,58,-3
2023,1,3110343,115,117,-2
2023,1,3110344,24,23,1
2023,1,3110345,138,135,3
2023,1,3110346,87,85,2
2023,1,3110348,145,152,-7
2023,1,3110349,27,30,-3
2023,1,3110350,88,95,-7
2023,1,3110351,108,115,-7
2023,1,3110352,187,194,-7
2023,1,3110353,113,118,-5
2023,1,3110354,74,74,0
2023,1,3110355,126,125,1
2023,1,3110356,106,109,-3
2023,1,3110357,111,114,-3
2023,1,3110358,142,151,-9
2023,1,3110359,167,172,-5
2023,1,3110360,205,217,-12
2023,1,3110361,82,92,-10
2023,1,3110362,193,203,-10
2023,1,3110363,43,46,-3
2023,1,3110364,176,188,-12
2023,1,3110365,137,141,-4
2023,1,3110366,122,123,-1
2023,1,3110367,153,154,-1
2023,1,3110368,147,157,-10
2023,1,3110369,302,304,-2
2023,1,3110370,168,168,0
2023,1,3110371,137,136,1
2023,1,3110372,130,132,-2
2023,1,3110373,179,180,-1
2023,1,3110374,338,354,-16
2023,1,3110375,69,73,-4
2023,1,3110376,336,360,-24
2023,1,3110377,91,98,-7
2023,1,3110378,111,114,-3
2023,1,3110379,42,47,-5
2023,1,3110380,27,29,-2
2023,1,3110381,55,53,2
2023,1,3110382,62,61,1
2023,1,3110383,98,104,-6
2023,1,3110387,174,178,-4
2023,1,3110388,81,86,-5
2023,1,3110389,68,70,-2
2023,1,3110390,180,174,6
2023,1,3110391,121,125,-4
2023,1,3110392,71,66,5
2023,1,3110393,55,57,-2
2023,1,3110394,246,255,-9
2023,1,3110395,114,116,-2
2023,1,3110396,211,217,-6
2023,1,3110397,383,396,-13
2023,1,3110398,239,243,-4
2023,1,3110399,266,273,-7
2023,1,3110400,254,269,-15
2023,1,3110401,59,62,-3
2023,1,3110402,181,179,2
2023,1,3110403,337,345,-8
2023,1,3110404,434,436,-2
2023,1,3110405,412,419,-7
2023,1,3110406,129,133,-4
2023,1,3110407,327,341,-14
2023,1,3110408,105,109,-4
2023,1,3110409,260,262,-2
2023,1,3110410,265,280,-15
2023,1,3110411,124,121,3
2023,1,3110412,23,23,0
2023,1,3110413,80,81,-1
2023,1,3110415,484,495,-11
2023,1,3110416,174,185,-11
2023,1,3110417,43,42,1
2023,1,3110418,71,69,2
2023,1,3110419,354,368,-14
2023,1,3110420,160,163,-3
2023,1,3110421,211,226,-15
2023,1,3110422,100,105,-5
2023,1,3110423,140,142,-2
2023,1,3110424,258,258,0
2023,1,3110425,262,263,-1
2023,1,3110426,251,260,-9
2023,1,3110427,45,45,0
2023,1,3110428,428,445,-17
2023,1,3110429,433,434,-1
2023,1,3110431,362,370,-8
2023,1,3110432,136,133,3
2023,1,3110433,218,212,6
2023,1,3110434,105,100,5
2023,1,3110435,84,85,-1
2023,1,3110436,77,77,0
2023,1,3110437,125,136,-11
2023,1,3110438,327,338,-11
2023,1,3110439,128,136,-8
2023,1,3110440,63,74,-11
2023,1,3110441,171,171,0
2023,1,3110442,46,49,-3
2023,1,3110443,52,50,2
2023,1,3110444,20,20,0
2023,1,3110446,59,69,-10
2023,1,3110447,40,42,-2
2023,1,3110448,77,81,-4
2023,1,3110449,222,223,-1
2023,1,3110450,357,367,-10
2023,1,3110451,242,255,-13
2023,1,3110452,174,186,-12
2023,1,3110453,313,310,3
2023,1,3110454,139,143,-4
2023,1,3110455,283,301,-18
2023,1,3110456,331,347,-16
2023,1,3110457,119,128,-9
2023,1,3110458,224,239,-15
2023,1,3110459,235,240,-5
2023,1,3110460,322,322,0
2023,1,3110461,68,70,-2
2023,1,3110462,134,161,-27
2023,1,3110463,98,102,-4
2023,1,3110464,201,199,2
2023,1,3110465,216,226,-10
2023,1,3110466,138,142,-4
2023,1,3110467,196,192,4
2023,1,3110468,447,459,-12
2023,1,3110469,433,445,-12
2023,1,3110470,116,114,2
2023,1,3110471,203,214,-11
2023,1,3110472,293,293,0
2023,1,3110473,352,355,-3
2023,1,3110474,127,138,-11
2023,1,3110475,135,128,7
2023,1,3110476,65,61,4
2023,1,3110477,219,232,-13
2023,1,3110478,143,151,-8
2023,1,3110479,175,180,-5
2023,1,3110480,100,101,-1
2023,1,3110481,277,294,-17
2023,1,3110482,49,52,-3
2023,1,3110483,61,69,-8
2023,1,3110484,179,188,-9
2023,1,3110485,127,128,-1
2023,1,3110486,195,199,-4
2023,1,3110487,69,70,-1
2023,1,3110488,173,181,-8
2023,1,3110489,73,73,0
2023,1,3110490,118,119,-1
2023,1,3110491,40,40,0
2023,1,3110493,83,82,1
2023,1,3110495,245,258,-13
2023,1,3110496,217,220,-3
2023,1,3110498,119,121,-2
2023,1,3110499,140,143,-3
2023,1,3110500,53,52,1
2023,1,3110501,59,62,-3
2023,1,3110502,279,286,-7
2023,1,3110503,345,341,4
2023,1,3110505,17,19,-2
2023,1,3110506,43,44,-1
2023,1,3110507,436,438,-2
2023,1,3110508,137,132,5
2023,1,3110509,336,369,-33
2023,1,3110510,74,80,-6
2023,1,3110511,131,136,-5
2023,1,3110512,96,102,-6
2023,1,3110513,108,105,3
2023,1,3110514,52,53,-1
2023,1,3110515,43,52,-9
2023,1,3110517,72,73,-1
2023,1,3110519,102,106,-4
2023,1,3110520,85,94,-9
2023,1,3110521,81,83,-2
2023,1,3110522,53,52,1
2023,1,3110523,20,22,-2
2023,1,3110524,52,51,1
2023,1,3110525,143,143,0
2023,1,3110526,34,38,-4
2023,1,3110527,138,130,8
2023,1,3110528,112,117,-5
2023,1,3110529,212,215,-3
2023,1,3110532,123,123,0
2023,1,3110533,26,24,2
2023,1,3110534,51,52,-1
2023,1,3110535,65,58,7
2023,1,3110536,43,42,1
2023,1,3110537,154,160,-6
2023,1,3110538,70,73,-3
2023,1,3110539,88,91,-3
2023,1,3110540,85,88,-3
2023,1,3110541,277,283,-6
2023,1,3110542,300,306,-6
2023,1,3110543,30,30,0
2023,1,3110544,1100,1080,20
2023,1,3110545,268,268,0
2023,1,3110546,86,87,-1
2023,1,3110547,256,264,-8
2023,1,3110548,175,171,4
2023,1,3110549,117,124,-7
2023,1,3110550,410,415,-5
2023,1,3110551,198,201,-3
2023,1,3110552,138,137,1
2023,1,3110553,174,172,2
2023,1,3110554,254,266,-12
2023,1,3110555,72,74,-2
2023,1,3110557,293,292,1
2023,1,3110558,433,437,-4
2023,1,3110559,442,457,-15
2023,1,3110560,122,118,4
2023,1,3110561,164,169,-5
2023,1,3110562,288,276,12
2023,1,3110563,54,57,-3
2023,1,3110564,239,226,13
2023,1,3110565,84,88,-4
2023,1,3110566,546,527,19
2023,1,3110567,82,86,-4
2023,1,3110568,82,85,-3
2023,1,3110569,313,308,5
2023,1,3110570,70,72,-2
2023,1,3110571,127,139,-12
2023,1,3110572,266,263,3
2023,1,3110573,31,32,-1
2023,1,3110574,52,47,5
2023,1,3110575,73,68,5
2023,1,3110576,235,223,12
2023,1,3110577,127,127,0
2023,1,3110578,313,320,-7
2023,1,3110579,78,77,1
2023,1,3110580,65,61,4
2023,1,3110582,164,170,-6
2023,1,3110583,49,47,2
2023,1,3110584,66,69,-3
2023,1,3110585,49,49,0
2023,1,3110586,339,344,-5
2023,1,3110587,142,144,-2
2023,1,3110588,90,95,-5
2023,1,3110589,39,40,-1
2023,1,3110590,127,132,-5
2023,1,3110591,85,93,-8
2023,1,3110592,60,61,-1
2023,1,3110593,244,248,-4
2023,1,3110594,116,119,-3
2023,1,3110595,266,287,-21
2023,1,3110596,108,107,1
2023,1,3110597,236,250,-14
2023,1,3110598,218,229,-11
2023,1,3110599,189,195,-6
2023,1,3110600,183,196,-13
2023,1,3110601,268,286,-18
2023,1,3110602,102,103,-1
2023,1,3110603,87,82,5
2023,1,3110604,228,236,-8
2023,1,3110605,104,98,6
2023,1,3110606,284,288,-4
2023,1,3110607,60,63,-3
2023,1,3110608,208,222,-14
2023,1,3110609,55,59,-4
2023,1,3110611,107,109,-2
2023,1,3110612,274,287,-13
2023,1,3110613,44,50,-6
2023,1,3110614,180,186,-6
2023,1,3110615,139,144,-5
2023,1,3110616,40,48,-8
2023,1,3110617,94,92,2
2023,1,3110618,221,230,-9
2023,1,3110619,83,86,-3
2023,1,3110620,368,379,-11
2023,1,3110621,70,74,-4
2023,1,3110622,167,166,1
2023,1,3110624,57,58,-1
2023,1,3110625,390,388,2
2023,1,3110626,181,186,-5
2023,1,3110627,266,257,9
2023,1,3110628,68,71,-3
2023,1,3110629,23,25,-2
2023,1,3110630,249,262,-13
2023,1,3110631,95,107,-12
2023,1,3110632,153,157,-4
2023,1,3110633,90,90,0
2023,1,3110634,437,455,-18
2023,1,3110635,145,142,3
2023,1,3110636,103,105,-2
2023,1,3110637,109,119,-10
2023,1,3110638,437,434,3
2023,1,3110639,106,109,-3
2023,1,3110640,160,170,-10
2023,1,3110641,105,103,2
2023,1,3110643,195,209,-14
2023,1,3110644,33,32,1
2023,1,3110645,370,370,0
2023,1,3110646,415,409,6
2023,1,3110647,371,389,-18
2023,1,3110649,197,202,-5
2023,1,3110650,78,77,1
2023,1,3110651,238,240,-2
2023,1,3110652,141,145,-4
2023,1,3110653,175,186,-11
2023,1,3110654,501,531,-30
2023,1,3110655,176,175,1
2023,1,3110656,490,509,-19
2023,1,3110657,381,387,-6
2023,1,3110658,152,156,-4
2023,1,3110659,510,517,-7
2023,1,3110660,562,561,1
2023,1,3110661,46,48,-2
2023,1,3110662,340,349,-9
2023,1,3110663,95,102,-7
2023,1,3110664,74,74,0
2023,1,3110665,299,313,-14
2023,1,3110666,38,43,-5
2023,1,3110668,342,342,0
2023,1,3110670,160,163,-3
2023,1,3110671,390,413,-23
2023,1,3110672,69,74,-5
2023,1,3110673,240,243,-3
2023,1,3110675,181,194,-13
2023,1,3110676,82,86,-4
2023,1,3110677,67,70,-3
2023,1,3110678,59,61,-2
2023,1,3110679,67,63,4
2023,1,3110680,80,82,-2
2023,1,3110681,32,32,0
2023,1,3110683,28,27,1
2023,1,3110684,80,82,-2
2023,1,3110686,179,185,-6
2023,1,3110687,36,38,-2
2023,1,3110688,90,93,-3
2023,1,3110689,154,157,-3
2023,1,3110690,376,381,-5
2023,1,3110691,170,171,-1
2023,1,3110692,62,71,-9
2023,1,3110693,21,21,0
2023,1,3110694,263,269,-6
2023,1,3110695,303,303,0
2023,1,3110696,70,74,-4
2023,1,3110697,91,95,-4
2023,1,3110698,124,131,-7
2023,1,3110699,133,130,3
2023,1,3110700,126,133,-7
2023,1,3110701,116,116,0
2023,1,3110702,98,103,-5
2023,1,3110703,210,216,-6
2023,1,3110706,187,182,5
2023,1,3110707,137,142,-5
2023,1,3110708,61,62,-1
2023,1,3110709,116,125,-9
2023,1,3110710,422,438,-16
2023,1,3110711,284,282,2
2023,1,3110712,269,274,-5
2023,1,3110713,514,520,-6
2023,1,3110714,368,371,-3
2023,1,3110715,44,43,1
2023,1,3110716,169,165,4
2023,1,3110717,418,433,-15
2023,1,3110718,268,271,-3
2023,1,3110719,37,34,3
2023,1,3110720,234,237,-3
2023,1,3110721,133,143,-10
2023,1,3110722,132,135,-3
2023,1,3110723,79,80,-1
2023,1,3110724,100,108,-8
2023,1,3110725,151,141,10
2023,1,3110726,95,97,-2
2023,1,3110727,67,76,-9
2023,1,3110728,75,78,-3
2023,1,3110729,206,211,-5
2023,1,3110730,155,205,-50
2023,1,3110731,203,202,1
2023,1,3110732,215,224,-9
2023,1,3110733,45,52,-7
2023,1,3110734,21,21,0
2023,1,3110735,219,222,-3
2023,1,3110736,223,237,-14
2023,1,3110737,134,140,-6
2023,1,3110738,307,316,-9
2023,1,3110739,19,21,-2
2023,1,3110740,148,156,-8
2023,1,3110741,194,200,-6
2023,1,3110742,131,131,0
2023,1,3110743,219,219,0
2023,1,3110744,319,327,-8
2023,1,3110745,166,167,-1
2023,1,3110746,116,118,-2
2023,1,3110747,92,93,-1
2023,1,3110748,103,106,-3
2023,1,3110749,203,207,-4
2023,1,3110750,167,174,-7
2023,1,3110751,150,157,-7
2023,1,3110752,237,254,-17
2023,1,3110753,239,241,-2
2023,1,3110754,162,163,-1
2023,1,3110755,162,170,-8
2023,1,3110756,109,119,-10
2023,1,3110757,234,245,-11
2023,1,3110758,39,42,-3
2023,1,3110760,220,226,-6
2023,1,3110762,616,641,-25
2023,1,3110765,95,101,-6
2023,1,3110766,202,206,-4
2023,1,3110767,20,19,1
2023,1,3110768,83,90,-7
2023,1,3110769,81,82,-1
2023,1,3110770,170,171,-1
2023,1,3110771,51,50,1
2023,1,3110772,36,36,0
2023,1,3110774,131,130,1
2023,1,3110775,103,106,-3
2023,1,3110776,147,157,-10
2023,1,3110777,64,67,-3
2023,1,3110778,370,374,-4
2023,1,3110780,77,83,-6
2023,1,3110781,131,131,0
2023,1,3110782,75,75,0
2023,1,3110783,130,127,3
2023,1,3110784,51,56,-5
2023,1,3110785,182,177,5
2023,1,3110786,74,77,-3
2023,1,3110787,200,201,-1
2023,1,3110788,40,44,-4
2023,1,3110789,196,195,1
2023,1,3110790,167,182,-15
2023,1,3110791,35,33,2
2023,1,3110792,206,213,-7
2023,1,3110794,159,175,-16
2023,1,3110795,54,55,-1
2023,1,3110796,39,45,-6
2023,1,3110798,34,30,4
2023,1,3110799,26,29,-3
2023,1,3110800,39,43,-4
2023,1,3110802,106,113,-7
2023,1,3110803,158,169,-11
2023,1,3110804,140,137,3
2023,1,3110805,50,50,0
2023,1,3110807,90,86,4
2023,1,3110809,69,71,-2
2023,1,3110810,265,269,-4
2023,1,3110811,91,93,-2
2023,1,3110812,109,110,-1
2023,1,3110813,282,291,-9
2023,1,3110814,179,186,-7
2023,1,3110815,243,254,-11
2023,1,3110816,89,96,-7
2023,1,3110817,35,43,-8
2023,1,3110818,29,35,-6
2023,1,3110819,300,295,5
2023,1,3110820,200,194,6
2023,1,3110821,155,163,-8
2023,1,3110822,63,68,-5
2023,1,3110823,101,105,-4
2023,1,3110824,78,79,-1
2023,1,3110825,219,232,-13
2023,1,3110826,217,226,-9
2023,1,3110827,129,134,-5
2023,1,3110828,284,301,-17
2023,1,3110829,62,75,-13
2023,1,3110830,93,94,-1
2023,1,3110831,98,104,-6
2023,1,3110832,126,127,-1
2023,1,3110833,131,128,3
2023,1,3110835,79,77,2
2023,1,3110836,468,475,-7
2023,1,3110837,240,240,0
2023,1,3110838,55,54,1
2023,1,3110839,212,210,2
2023,1,3110840,192,197,-5
2023,1,3110841,28,48,-20
2023,1,3110842,151,156,-5
2023,1,3110843,79,87,-8
2023,1,3110845,49,46,3
2023,1,3110846,372,384,-12
2023,1,3110847,65,77,-12
2023,1,3110848,182,183,-1
2023,1,3110849,171,182,-11
2023,1,3110850,475,480,-5
2023,1,3110851,100,105,-5
2023,1,3110852,118,119,-1
2023,1,3110853,85,89,-4
2023,1,3110854,67,68,-1
2023,1,3110855,374,406,-32
2023,1,3110856,237,234,3
2023,1,3110857,151,155,-4
2023,1,3110858,81,86,-5
2023,1,3110859,77,79,-2
2023,1,3110860,114,116,-2
2023,1,3110861,458,480,-22
2023,1,3110862,92,94,-2
2023,1,3110863,182,189,-7
2023,1,3110864,113,124,-11
2023,1,3110865,330,339,-9
2023,1,3110866,143,145,-2
2023,1,3110867,130,135,-5
2023,1,3110868,147,144,3
2023,1,3110869,405,424,-19
2023,1,3110871,159,161,-2
2023,1,3110872,56,58,-2
2023,1,3110873,278,282,-4
2023,1,3110874,96,108,-12
2023,1,3110875,72,83,-11
2023,1,3110876,133,137,-4
2023,1,3110877,203,218,-15
2023,1,3110878,39,41,-2
2023,1,3110879,85,86,-1
2023,1,3110880,48,51,-3
2023,1,3110881,616,644,-28
2023,1,3110882,226,228,-2
2023,1,3110883,251,257,-6
2023,1,3110884,118,120,-2
2023,1,3110885,195,201,-6
2023,1,3110886,119,131,-12
2023,1,3110887,46,47,-1
2023,1,3110888,140,136,4
2023,1,3110889,68,67,1
2023,1,3110890,151,153,-2
2023,1,3110891,133,136,-3
2023,1,3110892,529,540,-11
2023,1,3110893,25,25,0
2023,1,3110895,548,561,-13
2023,1,3110896,123,122,1
2023,1,3110897,204,199,5
2023,1,3110899,66,75,-9
2023,1,3110900,179,185,-6
2023,1,3110901,128,134,-6
2023,1,3110902,374,373,1
2023,1,3110903,221,220,1
2023,1,3110904,162,166,-4
2023,1,3110905,102,98,4
2023,1,3110906,56,63,-7
2023,1,3110907,299,296,3
2023,1,3110908,213,232,-19
2023,1,3110910,73,77,-4
2023,1,3110912,128,128,0
2023,1,3110913,156,169,-13
2023,1,3110915,90,91,-1
2023,1,3110916,171,169,2
2023,1,3110917,45,45,0
2023,1,3110918,127,122,5
2023,1,3110919,105,104,1
2023,1,3110921,60,57,3
2023,1,3110922,64,70,-6
2023,1,3110924,87,85,2
2023,1,3110925,120,116,4
2023,1,3110926,145,145,0
2023,1,3110929,209,206,3
2023,1,3110930,91,94,-3
2023,1,3110931,33,31,2
2023,1,3110932,54,55,-1
2023,1,3110934,208,223,-15
2023,1,3110935,72,75,-3
2023,1,3110936,85,85,0
2023,1,3110939,587,616,-29
2023,1,3110940,67,73,-6
2023,1,3110942,443,451,-8
2023,1,3110943,162,172,-10
2023,1,3110945,19,18,1
2023,1,3110947,23,24,-1
2023,1,3110949,150,148,2
2023,1,3110951,94,95,-1
2023,1,3110952,38,41,-3
2023,1,3110953,86,89,-3
2023,1,3110954,40,39,1
2023,1,3110955,430,435,-5
2023,1,3110956,57,57,0
2023,1,3110957,327,353,-26
2023,1,3110958,104,120,-16
2023,1,3110959,35,31,4
2023,1,3110961,165,167,-2
2023,1,3110966,331,343,-12
2023,1,3110967,124,125,-1
2023,1,3110968,61,60,1
2023,1,3110969,86,86,0
2023,1,3110970,65,62,3
2023,1,3110971,172,175,-3
2023,1,3110972,59,59,0
2023,1,3110973,157,165,-8
2023,1,3110974,68,69,-1
2023,1,3110975,49,50,-1
2023,1,3110976,173,180,-7
2023,1,3110979,60,60,0
2023,1,3110980,107,106,1
2023,1,3110981,195,203,-8
2023,1,3110982,86,89,-3
2023,1,3110983,110,105,5
2023,1,3110984,322,306,16
2023,1,3110988,59,58,1
2023,1,3110989,107,112,-5
2023,1,3110992,383,381,2
2023,1,3110994,247,237,10
2023,1,3110995,103,102,1
2023,1,3110996,112,109,3
2023,1,3110997,611,624,-13
2023,1,3110999,119,105,14
2023,1,3111001,69,61,8
2023,1,3111003,556,571,-15
2023,1,3111004,634,666,-32
2023,1,3111005,300,316,-16
2023,1,3111006,453,476,-23
2023,1,3111007,245,258,-13
2023,1,3111008,238,236,2
2023,1,3111009,95,98,-3
2023,1,3111010,435,442,-7
2023,1,3111011,107,105,2
2023,1,3111012,272,280,-8
2023,1,3111013,580,581,-1
2023,1,3111014,157,162,-5
2023,1,3111015,419,426,-7
2023,1,3111016,165,172,-7
2023,1,3111017,67,73,-6
2023,1,3111019,315,321,-6
2023,1,3111020,135,139,-4
2023,1,3111021,694,693,1
2023,1,3111022,96,98,-2
2023,1,3111023,154,153,1
2023,1,3111024,77,79,-2
2023,1,3111025,121,126,-5
2023,1,3111026,285,292,-7
2023,1,3111027,310,317,-7
2023,1,3111028,167,164,3
2023,1,3111029,88,92,-4
2023,1,3111030,180,186,-6
2023,1,3111031,148,152,-4
2023,1,3111032,196,199,-3
2023,1,3111033,59,62,-3
2023,1,3111034,225,234,-9
2023,1,3111035,128,135,-7
2023,1,3111036,59,62,-3
2023,1,3111037,44,44,0
2023,1,3111038,165,163,2
2023,1,3111039,134,143,-9
2023,1,3111040,61,63,-2
2023,1,3111042,279,288,-9
2023,1,3111043,60,61,-1
2023,1,3111044,275,282,-7
2023,1,3111045,43,44,-1
2023,1,3111046,487,500,-13
2023,1,3111047,80,79,1
2023,1,3111049,204,221,-17
2023,1,3111051,326,313,13
2023,1,3111052,287,297,-10
2023,1,3111053,241,252,-11
2023,1,3111054,49,49,0
2023,1,3111055,29,30,-1
2023,1,3111056,93,92,1
2023,1,3111057,223,231,-8
2023,1,3111058,83,86,-3
2023,1,3111059,604,627,-23
2023,1,3111060,505,531,-26
2023,1,3111061,345,364,-19
2023,1,3111062,171,169,2
2023,1,3111063,214,220,-6
2023,1,3111064,143,140,3
2023,1,3111065,65,72,-7
2023,1,3111066,205,217,-12
2023,1,3111067,331,346,-15
2023,1,3111068,35,38,-3
2023,1,3111069,132,134,-2
2023,1,3111070,67,80,-13
2023,1,3111071,44,51,-7
2023,1,3111072,227,233,-6
2023,1,3111073,361,363,-2
2023,1,3111074,100,107,-7
2023,1,3111075,141,141,0
2023,1,3111076,155,158,-3
2023,1,3111077,548,568,-20
2023,1,3111078,538,554,-16
2023,1,3111079,86,90,-4
2023,1,3111080,195,203,-8
2023,1,3111082,29,27,2
2023,1,3111083,177,183,-6
2023,1,3111084,38,40,-2
2023,1,3111085,271,277,-6
2023,1,3111086,225,219,6
2023,1,3111087,108,106,2
2023,1,3111088,168,168,0
2023,1,3111089,415,424,-9
2023,2,3110001,40,41,-1
2023,2,3110002,96,100,-4
2023,2,3110003,134,135,-1
2023,2,3110004,30,30,0
2023,2,3110005,82,87,-5
2023,2,3110006,23,26,-3
2023,2,3110007,73,74,-1
2023,2,3110008,256,250,6
2023,2,3110009,103,106,-3
2023,2,3110010,191,189,2
2023,2,3110012,594,632,-38
2023,2,3110014,44,46,-2
2023,2,3110016,109,115,-6
2023,2,3110017,53,52,1
2023,2,3110018,163,155,8
2023,2,3110020,114,116,-2
2023,2,3110021,133,133,0
2023,2,3110022,106,106,0
2023,2,3110023,46,46,0
2023,2,3110024,113,116,-3
2023,2,3110025,60,62,-2
2023,2,3110027,66,70,-4
2023,2,3110028,208,215,-7
2023,2,3110029,168,182,-14
2023,2,3110030,33,36,-3
2023,2,3110031,61,63,-2
2023,2,3110033,109,114,-5
2023,2,3110035,151,158,-7
2023,2,3110036,61,64,-3
2023,2,3110037,113,120,-7
2023,2,3110039,22,23,-1
2023,2,3110040,115,118,-3
2023,2,3110041,142,154,-12
2023,2,3110042,72,69,3
2023,2,3110043,223,218,5
2023,2,3110045,106,108,-2
2023,2,3110047,52,60,-8
2023,2,3110048,156,160,-4
2023,2,3110049,145,156,-11
2023,2,3110050,50,53,-3
2023,2,3110051,71,76,-5
2023,2,3110052,186,195,-9
2023,2,3110053,215,228,-13
2023,2,3110054,270,284,-14
2023,2,3110055,108,109,-1
2023,2,3110056,418,420,-2
2023,2,3110057,136,155,-19
2023,2,3110058,281,283,-2
2023,2,3110059,132,137,-5
2023,2,3110060,177,178,-1
2023,2,3110061,109,114,-5
2023,2,3110062,265,256,9
2023,2,3110063,270,286,-16
2023,2,3110064,187,187,0
2023,2,3110065,64,65,-1
2023,2,3110066,203,203,0
2023,2,3110067,195,209,-14
2023,2,3110068,320,323,-3
2023,2,3110069,490,503,-13
2023,2,3110070,37,38,-1
2023,2,3110071,79,80,-1
2023,2,3110073,108,97,11
2023,2,3110074,236,228,8
2023,2,3110075,139,142,-3
2023,2,3110077,84,86,-2
2023,2,3110078,82,88,-6
2023,2,3110079,381,383,-2
2023,2,3110080,182,171,11
2023,2,3110081,258,256,2
2023,2,3110082,170,153,17
2023,2,3110083,81,86,-5
2023,2,3110084,389,389,0
2023,2,3110085,347,359,-12
2023,2,3110087,127,128,-1
2023,2,3110088,90,91,-1
2023,2,3110089,59,65,-6
2023,2,3110090,116,126,-10
2023,2,3110092,147,157,-10
2023,2,3110093,375,401,-26
2023,2,3110095,276,256,20
2023,2,3110096,70,71,-1
2023,2,3110098,78,74,4
2023,2,3110099,111,103,8
2023,2,3110102,170,173,-3
2023,2,3110103,38,38,0
2023,2,3110104,99,105,-6
2023,2,3110105,138,137,1
2023,2,3110107,54,51,3
2023,2,3110109,141,142,-1
2023,2,3110110,105,109,-4
2023,2,3110112,135,135,0
2023,2,3110113,59,63,-4
2023,2,3110114,119,132,-13
2023,2,3110115,202,205,-3
2023,2,3110116,201,214,-13
2023,2,3110117,81,87,-6
2023,2,3110118,171,172,-1
2023,2,3110120,143,117,26
2023,2,3110121,71,77,-6
2023,2,3110122,210,217,-7
2023,2,3110123,157,166,-9
2023,2,3110124,191,195,-4
2023,2,3110125,127,134,-7
2023,2,3110126,36,31,5
2023,2,3110127,133,136,-3
2023,2,3110128,516,535,-19
2023,2,3110129,190,169,21
2023,2,3110130,45,47,-2
2023,2,3110131,491,461,30
2023,2,3110132,135,129,6
2023,2,3110133,86,90,-4
2023,2,3110134,327,335,-8
2023,2,3110135,162,173,-11
2023,2,3110136,467,459,8
2023,2,3110137,679,696,-17
2023,2,3110138,169,169,0
2023,2,3110139,299,294,5
2023,2,3110140,378,385,-7
2023,2,3110141,122,130,-8
2023,2,3110142,273,273,0
2023,2,3110144,69,67,2
2023,2,3110146,196,204,-8
2023,2,3110147,247,247,0
2023,2,3110148,82,82,0
2023,2,3110149,53,55,-2
2023,2,3110150,246,262,-16
2023,2,3110151,248,254,-6
2023,2,3110152,97,102,-5
2023,2,3110153,75,68,7
2023,2,3110154,266,267,-1
2023,2,3110155,167,171,-4
2023,2,3110156,189,198,-9
2023,2,3110157,236,246,-10
2023,2,3110158,323,346,-23
2023,2,3110159,447,452,-5
2023,2,3110160,55,54,1
2023,2,3110161,290,311,-21
2023,2,3110162,144,150,-6
2023,2,3110163,201,204,-3
2023,2,3110164,90,94,-4
2023,2,3110165,175,178,-3
2023,2,3110166,352,349,3
2023,2,3110167,303,312,-9
2023,2,3110168,113,114,-1
2023,2,3110169,128,137,-9
2023,2,3110170,245,263,-18
2023,2,3110171,36,37,-1
2023,2,3110172,158,158,0
2023,2,3110173,90,91,-1
2023,2,3110174,224,237,-13
2023,2,3110175,158,165,-7
2023,2,3110176,223,230,-7
2023,2,3110177,42,46,-4
2023,2,3110178,63,60,3
2023,2,3110179,109,115,-6
2023,2,3110180,227,232,-5
2023,2,3110181,230,240,-10
2023,2,3110182,102,105,-3
2023,2,3110183,107,111,-4
2023,2,3110184,42,44,-2
2023,2,3110185,46,49,-3
2023,2,3110186,60,62,-2
2023,2,3110187,380,394,-14
2023,2,3110188,217,232,-15
2023,2,3110189,101,112,-11
2023,2,3110190,103,107,-4
2023,2,3110191,155,152,3
2023,2,3110193,90,92,-2
2023,2,3110194,131,137,-6
2023,2,3110195,220,240,-20
2023,2,3110197,34,35,-1
2023,2,3110199,158,168,-10
2023,2,3110200,43,45,-2
2023,2,3110201,39,40,-1
2023,2,3110203,84,85,-1
2023,2,3110204,250,262,-12
2023,2,3110205,254,263,-9
2023,2,3110206,174,175,-1
2023,2,3110207,71,80,-9
2023,2,3110208,49,51,-2
2023,2,3110209,56,65,-9
2023,2,3110210,160,162,-2
2023,2,3110211,213,218,-5
2023,2,3110212,247,234,13
2023,2,3110213,36,39,-3
2023,2,3110214,98,105,-7
2023,2,3110215,64,71,-7
2023,2,3110216,152,153,-1
2023,2,3110217,413,417,-4
2023,2,3110218,190,199,-9
2023,2,3110219,277,285,-8
2023,2,3110220,362,357,5
2023,2,3110221,56,53,3
2023,2,3110224,86,85,1
2023,2,3110225,161,167,-6
2023,2,3110226,750,789,-39
2023,2,3110227,136,139,-3
2023,2,3110228,331,339,-8
2023,2,3110229,359,379,-20
2023,2,3110230,168,181,-13
2023,2,3110232,269,280,-11
2023,2,3110233,148,156,-8
2023,2,3110234,61,65,-4
2023,2,3110236,336,342,-6
2023,2,3110237,294,308,-14
2023,2,3110238,42,44,-2
2023,2,3110240,152,148,4
2023,2,3110241,315,320,-5
2023,2,3110242,149,158,-9
2023,2,3110243,289,292,-3
2023,2,3110244,188,189,-1
2023,2,3110245,55,58,-3
2023,2,3110246,197,210,-13
2023,2,3110247,278,283,-5
2023,2,3110248,45,51,-6
2023,2,3110249,287,303,-16
2023,2,3110250,81,77,4
2023,2,3110251,190,183,7
2023,2,3110252,221,230,-9
2023,2,3110253,198,198,0
2023,2,3110254,335,356,-21
2023,2,3110255,314,331,-17
2023,2,3110256,305,312,-7
2023,2,3110257,123,117,6
2023,2,3110258,200,208,-8
2023,2,3110259,229,229,0
2023,2,3110260,165,170,-5
2023,2,3110261,178,183,-5
2023,2,3110262,317,324,-7
2023,2,3110263,193,209,-16
2023,2,3110264,391,400,-9
2023,2,3110265,137,140,-3
2023,2,3110266,183,203,-20
2023,2,3110267,215,219,-4
2023,2,3110268,91,92,-1
2023,2,3110269,84,85,-1
2023,2,3110270,66,70,-4
2023,2,3110271,35,35,0
2023,2,3110272,397,402,-5
2023,2,3110273,141,137,4
2023,2,3110274,266,283,-17
2023,2,3110275,95,95,0
2023,2,3110276,29,28,1
2023,2,3110277,194,201,-7
2023,2,3110278,289,300,-11
2023,2,3110280,36,38,-2
2023,2,3110281,52,50,2
2023,2,3110282,61,66,-5
2023,2,3110283,77,75,2
2023,2,3110284,43,47,-4
2023,2,3110285,92,95,-3
2023,2,3110286,162,170,-8
2023,2,3110287,45,50,-5
2023,2,3110288,106,110,-4
2023,2,3110289,118,129,-11
2023,2,3110290,42,44,-2
2023,2,3110291,230,234,-4
2023,2,3110292,44,45,-1
2023,2,3110293,199,201,-2
2023,2,3110294,187,193,-6
2023,2,3110295,168,172,-4
2023,2,3110296,179,186,-7
2023,2,3110297,231,240,-9
2023,2,3110298,45,45,0
2023,2,3110299,296,294,2
2023,2,3110300,302,312,-10
2023,2,3110301,136,142,-6
2023,2,3110302,167,176,-9
2023,2,3110303,161,171,-10
2023,2,3110304,146,140,6
2023,2,3110305,235,248,-13
2023,2,3110306,92,91,1
2023,2,3110307,140,144,-4
2023,2,3110308,188,189,-1
2023,2,3110309,90,98,-8
2023,2,3110310,22,23,-1
2023,2,3110312,154,156,-2
2023,2,3110313,314,323,-9
2023,2,3110314,257,260,-3
2023,2,3110315,207,217,-10
2023,2,3110316,372,377,-5
2023,2,3110317,125,130,-5
2023,2,3110318,85,87,-2
2023,2,3110319,231,238,-7
2023,2,3110320,52,54,-2
2023,2,3110322,79,83,-4
2023,2,3110323,182,180,2
2023,2,3110325,150,149,1
2023,2,3110326,34,36,-2
2023,2,3110327,144,157,-13
2023,2,3110328,82,89,-7
2023,2,3110329,98,100,-2
2023,2,3110330,115,118,-3
2023,2,3110331,195,193,2
2023,2,3110332,59,66,-7
2023,2,3110333,190,190,0
2023,2,3110334,141,138,3
2023,2,3110335,289,300,-11
2023,2,3110336,63,66,-3
2023,2,3110337,86,92,-6
2023,2,3110340,55,55,0
2023,2,3110341,95,94,1
2023,2,3110342,53,59,-6
2023,2,3110343,114,119,-5
2023,2,3110344,24,22,2
2023,2,3110345,138,135,3
2023,2,3110346,88,84,4
2023,2,3110348,142,153,-11
2023,2,3110349,29,30,-1
2023,2,3110350,89,95,-6
2023,2,3110351,107,113,-6
2023,2,3110352,188,195,-7
2023,2,3110353,115,119,-4
2023,2,3110354,73,73,0
2023,2,3110355,126,125,1
2023,2,3110356,105,109,-4
2023,2,3110357,111,115,-4
2023,2,3110358,138,151,-13
2023,2,3110359,165,172,-7
2023,2,3110360,205,218,-13
2023,2,3110361,81,89,-8
2023,2,3110362,195,202,-7
2023,2,3110363,43,44,-1
2023,2,3110364,176,187,-11
2023,2,3110365,136,143,-7
2023,2,3110366,121,124,-3
2023,2,3110367,149,156,-7
2023,2,3110368,145,156,-11
2023,2,3110369,304,306,-2
2023,2,3110370,167,169,-2
2023,2,3110371,139,139,0
2023,2,3110372,131,134,-3
2023,2,3110373,180,183,-3
2023,2,3110374,332,359,-27
2023,2,3110375,70,75,-5
2023,2,3110376,335,353,-18
2023,2,3110377,89,97,-8
2023,2,3110378,109,113,-4
2023,2,3110379,42,46,-4
2023,2,3110380,27,29,-2
2023,2,3110381,55,53,2
2023,2,3110382,60,62,-2
2023,2,3110383,99,101,-2
2023,2,3110387,174,180,-6
2023,2,3110388,82,85,-3
2023,2,3110389,68,70,-2
2023,2,3110390,180,179,1
2023,2,3110391,118,122,-4
2023,2,3110392,68,68,0
2023,2,3110393,54,57,-3
2023,2,3110394,244,254,-10
2023,2,3110395,114,115,-1
2023,2,3110396,211,215,-4
2023,2,3110397,378,395,-17
2023,2,3110398,235,242,-7
2023,2,3110399,263,276,-13
2023,2,3110400,255,270,-15
2023,2,3110401,62,60,2
2023,2,3110402,181,182,-1
2023,2,3110403,335,349,-14
2023,2,3110404,426,436,-10
2023,2,3110405,411,424,-13
2023,2,3110406,125,135,-10
2023,2,3110407,331,342,-11
2023,2,3110408,107,109,-2
2023,2,3110409,264,263,1
2023,2,3110410,267,275,-8
2023,2,3110411,123,122,1
2023,2,3110412,24,22,2
2023,2,3110413,76,83,-7
2023,2,3110415,483,497,-14
2023,2,3110416,171,181,-10
2023,2,3110417,43,44,-1
2023,2,3110418,72,69,3
2023,2,3110419,349,364,-15
2023,2,3110420,157,163,-6
2023,2,3110421,211,226,-15
2023,2,3110422,102,106,-4
2023,2,3110423,139,146,-7
2023,2,3110424,266,257,9
2023,2,3110425,260,263,-3
2023,2,3110426,245,265,-20
2023,2,3110427,47,46,1
2023,2,3110428,428,445,-17
2023,2,3110429,436,434,2
2023,2,3110431,371,377,-6
2023,2,3110432,134,132,2
2023,2,3110433,220,213,7
2023,2,3110434,104,100,4
2023,2,3110435,85,85,0
2023,2,3110436,74,78,-4
2023,2,3110437,124,134,-10
2023,2,3110438,320,340,-20
2023,2,3110439,123,137,-14
2023,2,3110440,62,74,-12
2023,2,3110441,168,173,-5
2023,2,3110442,45,50,-5
2023,2,3110443,50,50,0
2023,2,3110444,20,20,0
2023,2,3110446,63,69,-6
2023,2,3110447,38,39,-1
2023,2,3110448,74,80,-6
2023,2,3110449,220,221,-1
2023,2,3110450,354,367,-13
2023,2,3110451,238,254,-16
2023,2,3110452,171,185,-14
2023,2,3110453,312,308,4
2023,2,3110454,140,144,-4
2023,2,3110455,287,297,-10
2023,2,3110456,329,348,-19
2023,2,3110457,121,125,-4
2023,2,3110458,222,240,-18
2023,2,3110459,234,242,-8
2023,2,3110460,319,322,-3
2023,2,3110461,67,71,-4
2023,2,3110462,131,161,-30
2023,2,3110463,98,101,-3
2023,2,3110464,204,201,3
2023,2,3110465,210,228,-18
2023,2,3110466,136,144,-8
2023,2,3110467,190,194,-4
2023,2,3110468,443,467,-24
2023,2,3110469,423,444,-21
2023,2,3110470,116,114,2
2023,2,3110471,200,214,-14
2023,2,3110472,293,292,1
2023,2,3110473,355,361,-6
2023,2,3110474,125,141,-16
2023,2,3110475,133,131,2
2023,2,3110476,66,62,4
2023,2,3110477,218,231,-13
2023,2,3110478,141,151,-10
2023,2,3110479,175,183,-8
2023,2,3110480,99,101,-2
2023,2,3110481,285,297,-12
2023,2,3110482,48,50,-2
2023,2,3110483,61,68,-7
2023,2,3110484,175,186,-11
2023,2,3110485,129,130,-1
2023,2,3110486,195,198,-3
2023,2,3110487,69,69,0
2023,2,3110488,177,183,-6
2023,2,3110489,70,75,-5
2023,2,3110490,120,119,1
2023,2,3110491,40,41,-1
2023,2,3110493,80,81,-1
2023,2,3110495,245,251,-6
2023,2,3110496,225,222,3
2023,2,3110498,117,121,-4
2023,2,3110499,141,140,1
2023,2,3110500,53,52,1
2023,2,3110501,61,61,0
2023,2,3110502,279,288,-9
2023,2,3110503,344,339,5
2023,2,3110505,18,18,0
2023,2,3110506,43,44,-1
2023,2,3110507,434,440,-6
2023,2,3110508,135,133,2
2023,2,3110509,330,366,-36
2023,2,3110510,73,78,-5
2023,2,3110511,130,135,-5
2023,2,3110512,98,100,-2
2023,2,3110513,106,106,0
2023,2,3110514,51,53,-2
2023,2,3110515,42,53,-11
2023,2,3110517,71,74,-3
2023,2,3110519,103,103,0
2023,2,3110520,86,92,-6
2023,2,3110521,82,80,2
2023,2,3110522,56,51,5
2023,2,3110523,20,19,1
2023,2,3110524,52,52,0
2023,2,3110525,140,145,-5
2023,2,3110526,36,37,-1
2023,2,3110527,139,134,5
2023,2,3110528,110,121,-11
2023,2,3110529,214,220,-6
2023,2,3110532,123,125,-2
2023,2,3110533,25,23,2
2023,2,3110534,50,53,-3
2023,2,3110535,65,63,2
2023,2,3110536,43,43,0
2023,2,3110537,158,159,-1
2023,2,3110538,67,73,-6
2023,2,3110539,91,90,1
2023,2,3110540,85,90,-5
2023,2,3110541,275,284,-9
2023,2,3110542,300,311,-11
2023,2,3110543,28,31,-3
2023,2,3110544,1113,1096,17
2023,2,3110545,267,271,-4
2023,2,3110546,89,89,0
2023,2,3110547,251,266,-15
2023,2,3110548,170,175,-5
2023,2,3110549,121,123,-2
2023,2,3110550,409,421,-12
2023,2,3110551,195,200,-5
2023,2,3110552,137,140,-3
2023,2,3110553,172,173,-1
2023,2,3110554,256,262,-6
2023,2,3110555,71,73,-2
2023,2,3110557,301,294,7
2023,2,3110558,441,433,8
2023,2,3110559,447,458,-11
2023,2,3110560,122,119,3
2023,2,3110561,169,167,2
2023,2,3110562,295,277,18
2023,2,3110563,57,57,0
2023,2,3110564,240,231,9
2023,2,3110565,84,86,-2
2023,2,3110566,557,546,11
2023,2,3110567,82,85,-3
2023,2,3110568,83,83,0
2023,2,3110569,311,313,-2
2023,2,3110570,70,70,0
2023,2,3110571,130,136,-6
2023,2,3110572,267,265,2
2023,2,3110573,30,31,-1
2023,2,3110574,52,48,4
2023,2,3110575,74,72,2
2023,2,3110576,239,231,8
2023,2,3110577,129,130,-1
2023,2,3110578,309,319,-10
2023,2,3110579,79,78,1
2023,2,3110580,64,63,1
2023,2,3110582,171,170,1
2023,2,3110583,47,47,0
2023,2,3110584,68,70,-2
2023,2,3110585,51,50,1
2023,2,3110586,333,345,-12
2023,2,3110587,144,146,-2
2023,2,3110588,90,93,-3
2023,2,3110589,38,38,0
2023,2,3110590,125,131,-6
2023,2,3110591,85,92,-7
2023,2,3110592,60,60,0
2023,2,3110593,244,251,-7
2023,2,3110594,117,119,-2
2023,2,3110595,264,282,-18
2023,2,3110596,106,109,-3
2023,2,3110597,235,250,-15
2023,2,3110598,214,228,-14
2023,2,3110599,187,198,-11
2023,2,3110600,183,196,-13
2023,2,3110601,266,282,-16
2023,2,3110602,102,104,-2
2023,2,3110603,88,84,4
2023,2,3110604,228,233,-5
2023,2,3110605,108,101,7
2023,2,3110606,280,290,-10
2023,2,3110607,61,64,-3
2023,2,3110608,212,222,-10
2023,2,3110609,55,57,-2
2023,2,3110611,109,111,-2
2023,2,3110612,269,290,-21
2023,2,3110613,42,47,-5
2023,2,3110614,171,189,-18
2023,2,3110615,141,141,0
2023,2,3110616,40,47,-7
2023,2,3110617,93,94,-1
2023,2,3110618,218,229,-11
2023,2,3110619,83,88,-5
2023,2,3110620,361,384,-23
2023,2,3110621,70,76,-6
2023,2,3110622,165,165,0
2023,2,3110624,54,59,-5
2023,2,3110625,391,392,-1
2023,2,3110626,179,188,-9
2023,2,3110627,261,258,3
2023,2,3110628,68,69,-1
2023,2,3110629,22,27,-5
2023,2,3110630,250,262,-12
2023,2,3110631,91,103,-12
2023,2,3110632,152,159,-7
2023,2,3110633,89,95,-6
2023,2,3110634,433,456,-23
2023,2,3110635,145,147,-2
2023,2,3110636,103,104,-1
2023,2,3110637,107,119,-12
2023,2,3110638,437,445,-8
2023,2,3110639,102,107,-5
2023,2,3110640,165,170,-5
2023,2,3110641,103,105,-2
2023,2,3110643,190,206,-16
2023,2,3110644,32,32,0
2023,2,3110645,370,374,-4
2023,2,3110646,407,415,-8
2023,2,3110647,376,394,-18
2023,2,3110649,200,207,-7
2023,2,3110650,79,76,3
2023,2,3110651,236,244,-8
2023,2,3110652,140,146,-6
2023,2,3110653,170,184,-14
2023,2,3110654,493,528,-35
2023,2,3110655,172,174,-2
2023,2,3110656,481,509,-28
2023,2,3110657,382,392,-10
2023,2,3110658,150,158,-8
2023,2,3110659,508,531,-23
2023,2,3110660,552,568,-16
2023,2,3110661,44,48,-4
2023,2,3110662,337,350,-13
2023,2,3110663,92,98,-6
2023,2,3110664,74,76,-2
2023,2,3110665,293,312,-19
2023,2,3110666,36,45,-9
2023,2,3110668,341,344,-3
2023,2,3110670,161,164,-3
2023,2,3110671,392,410,-18
2023,2,3110672,68,72,-4
2023,2,3110673,242,243,-1
2023,2,3110675,181,194,-13
2023,2,3110676,84,86,-2
2023,2,3110677,67,71,-4
2023,2,3110678,59,62,-3
2023,2,3110679,69,65,4
2023,2,3110680,79,83,-4
2023,2,3110681,32,31,1
2023,2,3110683,27,26,1
2023,2,3110684,79,80,-1
2023,2,3110686,178,186,-8
2023,2,3110687,37,38,-1
2023,2,3110688,89,91,-2
2023,2,3110689,153,158,-5
2023,2,3110690,381,385,-4
2023,2,3110691,167,171,-4
2023,2,3110692,64,70,-6
2023,2,3110693,22,22,0
2023,2,3110694,259,272,-13
2023,2,3110695,306,305,1
2023,2,3110696,69,72,-3
2023,2,3110697,93,94,-1
2023,2,3110698,124,126,-2
2023,2,3110699,131,131,0
2023,2,3110700,123,134,-11
2023,2,3110701,116,115,1
2023,2,3110702,96,104,-8
2023,2,3110703,210,217,-7
2023,2,3110706,189,182,7
2023,2,3110707,136,141,-5
2023,2,3110708,62,60,2
2023,2,3110709,114,123,-9
2023,2,3110710,418,446,-28
2023,2,3110711,280,285,-5
2023,2,3110712,260,278,-18
2023,2,3110713,516,522,-6
2023,2,3110714,370,371,-1
2023,2,3110715,44,43,1
2023,2,3110716,165,164,1
2023,2,3110717,419,432,-13
2023,2,3110718,269,272,-3
2023,2,3110719,38,36,2
2023,2,3110720,230,239,-9
2023,2,3110721,128,142,-14
2023,2,3110722,137,133,4
2023,2,3110723,81,81,0
2023,2,3110724,100,106,-6
2023,2,3110725,154,145,9
2023,2,3110726,90,96,-6
2023,2,3110727,67,73,-6
2023,2,3110728,74,77,-3
2023,2,3110729,206,211,-5
2023,2,3110730,155,155,0
2023,2,3110731,202,201,1
2023,2,3110732,212,223,-11
2023,2,3110733,43,50,-7
2023,2,3110734,22,22,0
2023,2,3110735,217,224,-7
2023,2,3110736,226,231,-5
2023,2,3110737,133,139,-6
2023,2,3110738,310,318,-8
2023,2,3110739,17,21,-4
2023,2,3110740,149,155,-6
2023,2,3110741,192,202,-10
2023,2,3110742,128,132,-4
2023,2,3110743,221,220,1
2023,2,3110744,321,331,-10
2023,2,3110745,162,170,-8
2023,2,3110746,112,122,-10
2023,2,3110747,93,93,0
2023,2,3110748,103,105,-2
2023,2,3110749,199,206,-7
2023,2,3110750,167,174,-7
2023,2,3110751,146,156,-10
2023,2,3110752,240,250,-10
2023,2,3110753,233,241,-8
2023,2,3110754,160,165,-5
2023,2,3110755,161,167,-6
2023,2,3110756,109,119,-10
2023,2,3110757,235,238,-3
2023,2,3110758,40,41,-1
2023,2,3110760,224,225,-1
2023,2,3110762,627,639,-12
2023,2,3110765,91,100,-9
2023,2,3110766,201,210,-9
2023,2,3110767,20,19,1
2023,2,3110768,82,90,-8
2023,2,3110769,80,85,-5
2023,2,3110770,175,169,6
2023,2,3110771,51,52,-1
2023,2,3110772,36,36,0
2023,2,3110774,131,132,-1
2023,2,3110775,107,103,4
2023,2,3110776,143,155,-12
2023,2,3110777,61,66,-5
2023,2,3110778,374,373,1
2023,2,3110780,74,81,-7
2023,2,3110781,128,134,-6
2023,2,3110782,75,74,1
2023,2,3110783,127,127,0
2023,2,3110784,51,54,-3
2023,2,3110785,181,182,-1
2023,2,3110786,72,76,-4
2023,2,3110787,196,204,-8
2023,2,3110788,40,44,-4
2023,2,3110789,194,198,-4
2023,2,3110790,168,181,-13
2023,2,3110791,35,35,0
2023,2,3110792,208,210,-2
2023,2,3110794,155,170,-15
2023,2,3110795,52,54,-2
2023,2,3110796,38,44,-6
2023,2,3110798,34,28,6
2023,2,3110799,25,29,-4
2023,2,3110800,41,40,1
2023,2,3110802,102,113,-11
2023,2,3110803,155,171,-16
2023,2,3110804,139,143,-4
2023,2,3110805,49,53,-4
2023,2,3110807,87,88,-1
2023,2,3110809,67,71,-4
2023,2,3110810,262,270,-8
2023,2,3110811,89,93,-4
2023,2,3110812,106,111,-5
2023,2,3110813,286,294,-8
2023,2,3110814,179,185,-6
2023,2,3110815,240,250,-10
2023,2,3110816,93,96,-3
2023,2,3110817,35,41,-6
2023,2,3110818,29,34,-5
2023,2,3110819,295,298,-3
2023,2,3110820,202,197,5
2023,2,3110821,156,159,-3
2023,2,3110822,63,64,-1
2023,2,3110823,107,104,3
2023,2,3110824,77,82,-5
2023,2,3110825,212,230,-18
2023,2,3110826,213,226,-13
2023,2,3110827,132,133,-1
2023,2,3110828,281,303,-22
2023,2,3110829,62,74,-12
2023,2,3110830,92,94,-2
2023,2,3110831,98,104,-6
2023,2,3110832,128,127,1
2023,2,3110833,129,129,0
2023,2,3110835,78,79,-1
2023,2,3110836,465,475,-10
2023,2,3110837,237,241,-4
2023,2,3110838,52,55,-3
2023,2,3110839,218,210,8
2023,2,3110840,193,202,-9
2023,2,3110841,26,47,-21
2023,2,3110842,152,154,-2
2023,2,3110843,80,87,-7
2023,2,3110845,48,46,2
2023,2,3110846,373,384,-11
2023,2,3110847,65,77,-12
2023,2,3110848,185,188,-3
2023,2,3110849,173,182,-9
2023,2,3110850,478,484,-6
2023,2,3110851,99,106,-7
2023,2,3110852,118,119,-1
2023,2,3110853,87,91,-4
2023,2,3110854,70,67,3
2023,2,3110855,371,400,-29
2023,2,3110856,233,235,-2
2023,2,3110857,153,154,-1
2023,2,3110858,83,86,-3
2023,2,3110859,75,80,-5
2023,2,3110860,112,114,-2
2023,2,3110861,455,476,-21
2023,2,3110862,93,93,0
2023,2,3110863,186,188,-2
2023,2,3110864,110,118,-8
2023,2,3110865,328,343,-15
2023,2,3110866,138,146,-8
2023,2,3110867,127,138,-11
2023,2,3110868,148,144,4
2023,2,3110869,401,417,-16
2023,2,3110871,160,167,-7
2023,2,3110872,55,57,-2
2023,2,3110873,276,279,-3
2023,2,3110874,94,108,-14
2023,2,3110875,73,83,-10
2023,2,3110876,135,138,-3
2023,2,3110877,208,217,-9
2023,2,3110878,38,41,-3
2023,2,3110879,84,85,-1
2023,2,3110880,46,50,-4
2023,2,3110881,610,640,-30
2023,2,3110882,227,232,-5
2023,2,3110883,239,258,-19
2023,2,3110884,121,123,-2
2023,2,3110885,193,202,-9
2023,2,3110886,118,132,-14
2023,2,3110887,45,47,-2
2023,2,3110888,140,137,3
2023,2,3110889,65,67,-2
2023,2,3110890,153,153,0
2023,2,3110891,132,136,-4
2023,2,3110892,531,543,-12
2023,2,3110893,25,25,0
2023,2,3110895,557,570,-13
2023,2,3110896,121,123,-2
2023,2,3110897,203,203,0
2023,2,3110899,65,76,-11
2023,2,3110900,180,185,-5
2023,2,3110901,126,132,-6
2023,2,3110902,373,371,2
2023,2,3110903,223,221,2
2023,2,3110904,164,166,-2
2023,2,3110905,102,98,4
2023,2,3110906,56,61,-5
2023,2,3110907,296,303,-7
2023,2,3110908,209,229,-20
2023,2,3110910,73,75,-2
2023,2,3110912,128,130,-2
2023,2,3110913,158,165,-7
2023,2,3110915,90,91,-1
2023,2,3110916,168,171,-3
2023,2,3110917,45,45,0
2023,2,3110918,124,121,3
2023,2,3110919,102,106,-4
2023,2,3110921,61,58,3
2023,2,3110922,65,70,-5
2023,2,3110924,88,87,1
2023,2,3110925,116,118,-2
2023,2,3110926,145,143,2
2023,2,3110929,205,206,-1
2023,2,3110930,92,96,-4
2023,2,3110931,32,33,-1
2023,2,3110932,54,56,-2
2023,2,3110934,209,218,-9
2023,2,3110935,67,75,-8
2023,2,3110936,82,86,-4
2023,2,3110939,580,615,-35
2023,2,3110940,68,73,-5
2023,2,3110942,448,457,-9
2023,2,3110943,166,170,-4
2023,2,3110945,22,19,3
2023,2,3110947,23,24,-1
2023,2,3110949,156,155,1
2023,2,3110951,96,95,1
2023,2,3110952,39,41,-2
2023,2,3110953,88,89,-1
2023,2,3110954,40,41,-1
2023,2,3110955,427,439,-12
2023,2,3110956,56,54,2
2023,2,3110957,313,348,-35
2023,2,3110958,103,115,-12
2023,2,3110959,33,33,0
2023,2,3110961,161,166,-5
2023,2,3110966,337,342,-5
2023,2,3110967,123,127,-4
2023,2,3110968,61,60,1
2023,2,3110969,86,85,1
2023,2,3110970,68,60,8
2023,2,3110971,165,173,-8
2023,2,3110972,60,60,0
2023,2,3110973,158,167,-9
2023,2,3110974,65,69,-4
2023,2,3110975,48,50,-2
2023,2,3110976,174,182,-8
2023,2,3110979,58,60,-2
2023,2,3110980,107,106,1
2023,2,3110981,192,205,-13
2023,2,3110982,86,85,1
2023,2,3110983,110,105,5
2023,2,3110984,318,310,8
2023,2,3110988,59,58,1
2023,2,3110989,105,114,-9
2023,2,3110992,391,385,6
2023,2,3110994,251,240,11
2023,2,3110995,103,103,0
2023,2,3110996,112,109,3
2023,2,3110997,612,623,-11
2023,2,3110999,119,113,6
2023,2,3111001,68,63,5
2023,2,3111003,554,572,-18
2023,2,3111004,625,664,-39
2023,2,3111005,298,310,-12
2023,2,3111006,453,473,-20
2023,2,3111007,241,257,-16
2023,2,3111008,235,240,-5
2023,2,3111009,96,99,-3
2023,2,3111010,434,442,-8
2023,2,3111011,108,109,-1
2023,2,3111012,262,281,-19
2023,2,3111013,586,585,1
2023,2,3111014,154,165,-11
2023,2,3111015,420,426,-6
2023,2,3111016,168,171,-3
2023,2,3111017,69,71,-2
2023,2,3111019,313,319,-6
2023,2,3111020,136,143,-7
2023,2,3111021,696,710,-14
2023,2,3111022,96,98,-2
2023,2,3111023,154,156,-2
2023,2,3111024,78,79,-1
2023,2,3111025,122,128,-6
2023,2,3111026,275,294,-19
2023,2,3111027,313,320,-7
2023,2,3111028,168,169,-1
2023,2,3111029,91,91,0
2023,2,3111030,179,184,-5
2023,2,3111031,146,151,-5
2023,2,3111032,194,199,-5
2023,2,3111033,59,61,-2
2023,2,3111034,222,233,-11
2023,2,3111035,126,136,-10
2023,2,3111036,59,62,-3
2023,2,3111037,46,43,3
2023,2,3111038,166,166,0
2023,2,3111039,134,143,-9
2023,2,3111040,61,63,-2
2023,2,3111042,279,289,-10
2023,2,3111043,59,60,-1
2023,2,3111044,276,284,-8
2023,2,3111045,42,45,-3
2023,2,3111046,490,500,-10
2023,2,3111047,79,80,-1
2023,2,3111049,208,217,-9
2023,2,3111051,324,319,5
2023,2,3111052,290,294,-4
2023,2,3111053,244,253,-9
2023,2,3111054,51,49,2
2023,2,3111055,29,30,-1
2023,2,3111056,89,93,-4
2023,2,3111057,221,234,-13
2023,2,3111058,84,86,-2
2023,2,3111059,603,632,-29
2023,2,3111060,493,539,-46
2023,2,3111061,336,358,-22
2023,2,3111062,172,175,-3
2023,2,3111063,214,223,-9
2023,2,3111064,141,148,-7
2023,2,3111065,65,71,-6
2023,2,3111066,203,213,-10
2023,2,3111067,334,345,-11
2023,2,3111068,34,37,-3
2023,2,3111069,132,134,-2
2023,2,3111070,65,76,-11
2023,2,3111071,43,48,-5
2023,2,3111072,224,235,-11
2023,2,3111073,360,365,-5
2023,2,3111074,100,104,-4
2023,2,3111075,147,140,7
2023,2,3111076,152,161,-9
2023,2,3111077,545,569,-24
2023,2,3111078,539,557,-18
2023,2,3111079,87,90,-3
2023,2,3111080,194,204,-10
2023,2,3111082,28,29,-1
2023,2,3111083,180,186,-6
2023,2,3111084,37,40,-3
2023,2,3111085,270,276,-6
2023,2,3111086,228,221,7
2023,2,3111087,104,106,-2
2023,2,3111088,166,171,-5
2023,2,3111089,418,432,-14
2023,3,3110001,39,41,-2
2023,3,3110002,94,100,-6
2023,3,3110003,133,133,0
2023,3,3110004,31,31,0
2023,3,3110005,80,87,-7
2023,3,3110006,24,25,-1
2023,3,3110007,71,75,-4
2023,3,3110008,261,248,13
2023,3,3110009,103,107,-4
2023,3,3110010,190,189,1
2023,3,3110012,581,617,-36
2023,3,3110014,43,45,-2
2023,3,3110016,108,114,-6
2023,3,3110017,53,53,0
2023,3,3110018,167,161,6
2023,3,3110020,116,117,-1
2023,3,3110021,135,132,3
2023,3,3110022,107,105,2
2023,3,3110023,46,47,-1
2023,3,3110024,109,118,-9
2023,3,3110025,58,62,-4
2023,3,3110027,68,70,-2
2023,3,3110028,206,210,-4
2023,3,3110029,168,178,-10
2023,3,3110030,34,35,-1
2023,3,3110031,60,63,-3
2023,3,3110033,110,113,-3
2023,3,3110035,147,155,-8
2023,3,3110036,60,63,-3
2023,3,3110037,109,119,-10
2023,3,3110039,22,23,-1
2023,3,3110040,115,117,-2
2023,3,3110041,144,150,-6
2023,3,3110042,70,70,0
2023,3,3110043,221,217,4
2023,3,3110045,108,108,0
2023,3,3110047,54,60,-6
2023,3,3110048,156,156,0
2023,3,3110049,146,157,-11
2023,3,3110050,51,53,-2
2023,3,3110051,69,74,-5
2023,3,3110052,187,190,-3
2023,3,3110053,218,223,-5
2023,3,3110054,273,277,-4
2023,3,3110055,111,110,1
2023,3,3110056,416,422,-6
2023,3,3110057,133,151,-18
2023,3,3110058,276,276,0
2023,3,3110059,133,135,-2
2023,3,3110060,173,175,-2
2023,3,3110061,109,117,-8
2023,3,3110062,266,258,8
2023,3,3110063,272,284,-12
2023,3,3110064,190,186,4
2023,3,3110065,65,65,0
2023,3,3110066,200,203,-3
2023,3,3110067,200,209,-9
2023,3,3110068,318,322,-4
2023,3,3110069,504,498,6
2023,3,3110070,38,38,0
2023,3,3110071,78,79,-1
2023,3,3110073,110,97,13
2023,3,3110074,236,232,4
2023,3,3110075,139,140,-1
2023,3,3110077,83,84,-1
2023,3,3110078,80,88,-8
2023,3,3110079,386,379,7
2023,3,3110080,180,171,9
2023,3,3110081,256,258,-2
2023,3,3110082,167,156,11
2023,3,3110083,80,84,-4
2023,3,3110084,389,389,0
2023,3,3110085,345,352,-7
2023,3,3110087,128,127,1
2023,3,3110088,93,90,3
2023,3,3110089,61,63,-2
2023,3,3110090,116,126,-10
2023,3,3110092,149,158,-9
2023,3,3110093,368,393,-25
2023,3,3110095,274,262,12
2023,3,3110096,75,70,5
2023,3,3110098,76,71,5
2023,3,3110099,112,104,8
2023,3,3110102,170,170,0
2023,3,3110103,38,36,2
2023,3,3110104,96,105,-9
2023,3,3110105,140,139,1
2023,3,3110107,55,53,2
2023,3,3110109,140,145,-5
2023,3,3110110,105,106,-1
2023,3,3110112,132,132,0
2023,3,3110113,60,63,-3
2023,3,3110114,115,128,-13
2023,3,3110115,206,205,1
2023,3,3110116,197,212,-15
2023,3,3110117,80,83,-3
2023,3,3110118,172,176,-4
2023,3,3110120,144,123,21
2023,3,3110121,70,73,-3
2023,3,3110122,207,217,-10
2023,3,3110123,157,164,-7
2023,3,3110124,192,195,-3
2023,3,3110125,127,132,-5
2023,3,3110126,36,33,3
2023,3,3110127,136,133,3
2023,3,3110128,499,523,-24
2023,3,3110129,189,173,16
2023,3,3110130,45,46,-1
2023,3,3110131,502,462,40
2023,3,3110132,132,134,-2
2023,3,3110133,85,89,-4
2023,3,3110134,323,330,-7
2023,3,3110135,162,169,-7
2023,3,3110136,482,463,19
2023,3,3110137,676,689,-13
2023,3,3110138,176,164,12
2023,3,3110139,299,290,9
2023,3,3110140,400,382,18
2023,3,3110141,123,126,-3
2023,3,3110142,274,272,2
2023,3,3110144,69,64,5
2023,3,3110146,199,201,-2
2023,3,3110147,242,246,-4
2023,3,3110148,84,81,3
2023,3,3110149,52,56,-4
2023,3,3110150,249,260,-11
2023,3,3110151,245,254,-9
2023,3,3110152,94,101,-7
2023,3,3110153,74,67,7
2023,3,3110154,263,264,-1
2023,3,3110155,169,171,-2
2023,3,3110156,190,196,-6
2023,3,3110157,235,244,-9
2023,3,3110158,314,344,-30
2023,3,3110159,435,455,-20
2023,3,3110160,58,56,2
2023,3,3110161,286,301,-15
2023,3,3110162,144,150,-6
2023,3,3110163,194,199,-5
2023,3,3110164,96,94,2
2023,3,3110165,174,180,-6
2023,3,3110166,349,345,4
2023,3,3110167,297,312,-15
2023,3,3110168,111,113,-2
2023,3,3110169,124,134,-10
2023,3,3110170,239,261,-22
2023,3,3110171,35,35,0
2023,3,3110172,161,164,-3
2023,3,3110173,93,92,1
2023,3,3110174,228,231,-3
2023,3,3110175,157,164,-7
2023,3,3110176,223,230,-7
2023,3,3110177,42,46,-4
2023,3,3110178,63,60,3
2023,3,3110179,103,113,-10
2023,3,3110180,228,231,-3
2023,3,3110181,227,237,-10
2023,3,3110182,103,103,0
2023,3,3110183,108,112,-4
2023,3,3110184,44,44,0
2023,3,3110185,46,49,-3
2023,3,3110186,63,58,5
2023,3,3110187,373,395,-22
2023,3,3110188,213,225,-12
2023,3,3110189,99,108,-9
2023,3,3110190,99,103,-4
2023,3,3110191,158,157,1
2023,3,3110193,94,92,2
2023,3,3110194,132,135,-3
2023,3,3110195,223,232,-9
2023,3,3110197,33,35,-2
2023,3,3110199,158,164,-6
2023,3,3110200,43,43,0
2023,3,3110201,38,39,-1
2023,3,3110203,85,85,0
2023,3,3110204,252,259,-7
2023,3,3110205,258,266,-8
2023,3,3110206,172,176,-4
2023,3,3110207,72,76,-4
2023,3,3110208,46,50,-4
2023,3,3110209,56,61,-5
2023,3,3110210,163,160,3
2023,3,3110211,211,217,-6
2023,3,3110212,246,233,13
2023,3,3110213,34,39,-5
2023,3,3110214,97,104,-7
2023,3,3110215,63,68,-5
2023,3,3110216,145,154,-9
2023,3,3110217,356,417,-61
2023,3,3110218,188,196,-8
2023,3,3110219,279,283,-4
2023,3,3110220,358,357,1
2023,3,3110221,57,54,3
2023,3,3110224,87,84,3
2023,3,3110225,161,164,-3
2023,3,3110226,739,780,-41
2023,3,3110227,135,136,-1
2023,3,3110228,331,337,-6
2023,3,3110229,365,374,-9
2023,3,3110230,165,176,-11
2023,3,3110232,270,278,-8
2023,3,3110233,147,154,-7
2023,3,3110234,60,63,-3
2023,3,3110236,338,336,2
2023,3,3110237,291,302,-11
2023,3,3110238,44,44,0
2023,3,3110240,153,146,7
2023,3,3110241,309,320,-11
2023,3,3110242,141,150,-9
2023,3,3110243,291,289,2
2023,3,3110244,184,189,-5
2023,3,3110245,53,58,-5
2023,3,3110246,195,204,-9
2023,3,3110247,276,277,-1
2023,3,3110248,44,49,-5
2023,3,3110249,287,294,-7
2023,3,3110250,81,77,4
2023,3,3110251,192,188,4
2023,3,3110252,216,224,-8
2023,3,3110253,202,196,6
2023,3,3110254,325,343,-18
2023,3,3110255,315,324,-9
2023,3,3110256,301,311,-10
2023,3,3110257,119,118,1
2023,3,3110258,197,209,-12
2023,3,3110259,227,229,-2
2023,3,3110260,164,172,-8
2023,3,3110261,180,182,-2
2023,3,3110262,317,321,-4
2023,3,3110263,183,207,-24
2023,3,3110264,387,395,-8
2023,3,3110265,139,139,0
2023,3,3110266,180,197,-17
2023,3,3110267,208,213,-5
2023,3,3110268,88,93,-5
2023,3,3110269,85,86,-1
2023,3,3110270,63,71,-8
2023,3,3110271,35,36,-1
2023,3,3110272,400,393,7
2023,3,3110273,136,139,-3
2023,3,3110274,264,274,-10
2023,3,3110275,96,93,3
2023,3,3110276,29,29,0
2023,3,3110277,193,199,-6
2023,3,3110278,286,294,-8
2023,3,3110280,36,38,-2
2023,3,3110281,51,49,2
2023,3,3110282,59,61,-2
2023,3,3110283,77,76,1
2023,3,3110284,43,47,-4
2023,3,3110285,92,93,-1
2023,3,3110286,159,167,-8
2023,3,3110287,46,50,-4
2023,3,3110288,105,107,-2
2023,3,3110289,117,129,-12
2023,3,3110290,42,42,0
2023,3,3110291,232,230,2
2023,3,3110292,44,45,-1
2023,3,3110293,198,200,-2
2023,3,3110294,192,191,1
2023,3,3110295,171,170,1
2023,3,3110296,176,182,-6
2023,3,3110297,231,240,-9
2023,3,3110298,41,45,-4
2023,3,3110299,294,294,0
2023,3,3110300,300,308,-8
2023,3,3110301,133,144,-11
2023,3,3110302,170,173,-3
2023,3,3110303,163,170,-7
2023,3,3110304,144,142,2
2023,3,3110305,240,246,-6
2023,3,3110306,91,90,1
2023,3,3110307,138,140,-2
2023,3,3110308,186,187,-1
2023,3,3110309,91,95,-4
2023,3,3110310,21,22,-1
2023,3,3110312,155,153,2
2023,3,3110313,308,315,-7
2023,3,3110314,254,256,-2
2023,3,3110315,204,209,-5
2023,3,3110316,373,380,-7
2023,3,3110317,123,130,-7
2023,3,3110318,86,85,1
2023,3,3110319,226,233,-7
2023,3,3110320,52,54,-2
2023,3,3110322,79,80,-1
2023,3,3110323,181,179,2
2023,3,3110325,148,151,-3
2023,3,3110326,31,34,-3
2023,3,3110327,143,152,-9
2023,3,3110328,82,86,-4
2023,3,3110329,97,96,1
2023,3,3110330,112,118,-6
2023,3,3110331,198,194,4
2023,3,3110332,58,66,-8
2023,3,3110333,186,190,-4
2023,3,3110334,136,140,-4
2023,3,3110335,289,296,-7
2023,3,3110336,62,66,-4
2023,3,3110337,84,89,-5
2023,3,3110340,57,54,3
2023,3,3110341,92,96,-4
2023,3,3110342,53,57,-4
2023,3,3110343,114,115,-1
2023,3,3110344,24,23,1
2023,3,3110345,132,138,-6
2023,3,3110346,89,83,6
2023,3,3110348,139,151,-12
2023,3,3110349,28,30,-2
2023,3,3110350,85,91,-6
2023,3,3110351,107,109,-2
2023,3,3110352,185,194,-9
2023,3,3110353,117,116,1
2023,3,3110354,72,74,-2
2023,3,3110355,125,127,-2
2023,3,3110356,105,108,-3
2023,3,3110357,110,112,-2
2023,3,3110358,141,148,-7
2023,3,3110359,159,173,-14
2023,3,3110360,204,211,-7
2023,3,3110361,77,86,-9
2023,3,3110362,191,201,-10
2023,3,3110363,43,43,0
2023,3,3110364,172,178,-6
2023,3,3110365,134,140,-6
2023,3,3110366,118,125,-7
2023,3,3110367,145,153,-8
2023,3,3110368,142,153,-11
2023,3,3110369,301,305,-4
2023,3,3110370,165,166,-1
2023,3,3110371,133,143,-10
2023,3,3110372,129,132,-3
2023,3,3110373,180,182,-2
2023,3,3110374,327,349,-22
2023,3,3110375,66,73,-7
2023,3,3110376,340,348,-8
2023,3,3110377,86,95,-9
2023,3,3110378,109,115,-6
2023,3,3110379,41,46,-5
2023,3,3110380,28,29,-1
2023,3,3110381,57,50,7
2023,3,3110382,56,64,-8
2023,3,3110383,97,101,-4
2023,3,3110387,170,179,-9
2023,3,3110388,81,84,-3
2023,3,3110389,70,69,1
2023,3,3110390,183,174,9
2023,3,3110391,120,123,-3
2023,3,3110392,68,68,0
2023,3,3110393,55,55,0
2023,3,3110394,244,254,-10
2023,3,3110395,112,114,-2
2023,3,3110396,212,215,-3
2023,3,3110397,379,395,-16
2023,3,3110398,240,235,5
2023,3,3110399,261,269,-8
2023,3,3110400,248,262,-14
2023,3,3110401,62,59,3
2023,3,3110402,179,182,-3
2023,3,3110403,327,355,-28
2023,3,3110404,426,436,-10
2023,3,3110405,405,420,-15
2023,3,3110406,128,132,-4
2023,3,3110407,330,329,1
2023,3,3110408,108,106,2
2023,3,3110409,261,264,-3
2023,3,3110410,262,273,-11
2023,3,3110411,124,123,1
2023,3,3110412,24,23,1
2023,3,3110413,71,84,-13
2023,3,3110415,478,487,-9
2023,3,3110416,171,176,-5
2023,3,3110417,42,43,-1
2023,3,3110418,70,70,0
2023,3,3110419,347,353,-6
2023,3,3110420,161,163,-2
2023,3,3110421,208,220,-12
2023,3,3110422,102,104,-2
2023,3,3110423,140,143,-3
2023,3,3110424,254,258,-4
2023,3,3110425,252,261,-9
2023,3,3110426,244,261,-17
2023,3,3110427,49,45,4
2023,3,3110428,426,435,-9
2023,3,3110429,435,428,7
2023,3,3110431,377,371,6
2023,3,3110432,133,130,3
2023,3,3110433,219,220,-1
2023,3,3110434,104,103,1
2023,3,3110435,83,83,0
2023,3,3110436,73,76,-3
2023,3,3110437,126,134,-8
2023,3,3110438,318,335,-17
2023,3,3110439,119,137,-18
2023,3,3110440,61,72,-11
2023,3,3110441,170,171,-1
2023,3,3110442,48,50,-2
2023,3,3110443,43,51,-8
2023,3,3110444,20,20,0
2023,3,3110446,61,66,-5
2023,3,3110447,39,40,-1
2023,3,3110448,73,80,-7
2023,3,3110449,215,219,-4
2023,3,3110450,348,359,-11
2023,3,3110451,231,251,-20
2023,3,3110452,173,182,-9
2023,3,3110453,302,308,-6
2023,3,3110454,134,144,-10
2023,3,3110455,280,297,-17
2023,3,3110456,329,342,-13
2023,3,3110457,121,123,-2
2023,3,3110458,224,234,-10
2023,3,3110459,232,240,-8
2023,3,3110460,313,323,-10
2023,3,3110461,69,69,0
2023,3,3110462,127,161,-34
2023,3,3110463,100,99,1
2023,3,3110464,203,203,0
2023,3,3110465,208,222,-14
2023,3,3110466,135,143,-8
2023,3,3110467,188,191,-3
2023,3,3110468,435,461,-26
2023,3,3110469,420,437,-17
2023,3,3110470,121,117,4
2023,3,3110471,194,215,-21
2023,3,3110472,286,295,-9
2023,3,3110473,350,360,-10
2023,3,3110474,124,137,-13
2023,3,3110475,135,132,3
2023,3,3110476,65,62,3
2023,3,3110477,216,229,-13
2023,3,3110478,138,148,-10
2023,3,3110479,177,179,-2
2023,3,3110480,97,100,-3
2023,3,3110481,277,285,-8
2023,3,3110482,47,49,-2
2023,3,3110483,60,67,-7
2023,3,3110484,175,185,-10
2023,3,3110485,126,133,-7
2023,3,3110486,193,199,-6
2023,3,3110487,69,69,0
2023,3,3110488,176,178,-2
2023,3,3110489,69,73,-4
2023,3,3110490,122,118,4
2023,3,3110491,40,40,0
2023,3,3110493,80,83,-3
2023,3,3110495,248,250,-2
2023,3,3110496,226,221,5
2023,3,3110498,115,122,-7
2023,3,3110499,135,143,-8
2023,3,3110500,53,52,1
2023,3,3110501,58,60,-2
2023,3,3110502,272,287,-15
2023,3,3110503,333,341,-8
2023,3,3110505,18,18,0
2023,3,3110506,41,42,-1
2023,3,3110507,432,441,-9
2023,3,3110508,137,133,4
2023,3,3110509,325,359,-34
2023,3,3110510,76,79,-3
2023,3,3110511,125,134,-9
2023,3,3110512,101,99,2
2023,3,3110513,107,106,1
2023,3,3110514,51,52,-1
2023,3,3110515,42,46,-4
2023,3,3110517,70,72,-2
2023,3,3110519,102,100,2
2023,3,3110520,89,91,-2
2023,3,3110521,82,80,2
2023,3,3110522,53,54,-1
2023,3,3110523,20,19,1
2023,3,3110524,51,52,-1
2023,3,3110525,138,139,-1
2023,3,3110526,35,37,-2
2023,3,3110527,140,135,5
2023,3,3110528,108,115,-7
2023,3,3110529,209,219,-10
2023,3,3110532,123,125,-2
2023,3,3110533,26,24,2
2023,3,3110534,49,52,-3
2023,3,3110535,62,63,-1
2023,3,3110536,43,42,1
2023,3,3110537,154,155,-1
2023,3,3110538,64,70,-6
2023,3,3110539,87,92,-5
2023,3,3110540,84,90,-6
2023,3,3110541,276,280,-4
2023,3,3110542,303,306,-3
2023,3,3110543,27,31,-4
2023,3,3110544,1102,1092,10
2023,3,3110545,267,271,-4
2023,3,3110546,89,87,2
2023,3,3110547,255,260,-5
2023,3,3110548,171,172,-1
2023,3,3110549,120,120,0
2023,3,3110550,408,410,-2
2023,3,3110551,197,201,-4
2023,3,3110552,131,138,-7
2023,3,3110553,171,176,-5
2023,3,3110554,254,259,-5
2023,3,3110555,71,72,-1
2023,3,3110557,302,288,14
2023,3,3110558,445,435,10
2023,3,3110559,434,456,-22
2023,3,3110560,117,121,-4
2023,3,3110561,166,164,2
2023,3,3110562,287,278,9
2023,3,3110563,57,58,-1
2023,3,3110564,242,233,9
2023,3,3110565,87,86,1
2023,3,3110566,570,549,21
2023,3,3110567,80,84,-4
2023,3,3110568,85,83,2
2023,3,3110569,307,309,-2
2023,3,3110570,70,69,1
2023,3,3110571,129,132,-3
2023,3,3110572,273,267,6
2023,3,3110573,30,30,0
2023,3,3110574,50,48,2
2023,3,3110575,77,70,7
2023,3,3110576,241,234,7
2023,3,3110577,137,131,6
2023,3,3110578,313,314,-1
2023,3,3110579,81,78,3
2023,3,3110580,65,65,0
2023,3,3110582,173,167,6
2023,3,3110583,46,48,-2
2023,3,3110584,68,66,2
2023,3,3110585,53,50,3
2023,3,3110586,334,342,-8
2023,3,3110587,145,146,-1
2023,3,3110588,92,91,1
2023,3,3110589,37,39,-2
2023,3,3110590,128,132,-4
2023,3,3110591,83,87,-4
2023,3,3110592,61,60,1
2023,3,3110593,241,243,-2
2023,3,3110594,115,119,-4
2023,3,3110595,261,279,-18
2023,3,3110596,105,113,-8
2023,3,3110597,231,237,-6
2023,3,3110598,208,224,-16
2023,3,3110599,185,196,-11
2023,3,3110600,182,190,-8
2023,3,3110601,263,274,-11
2023,3,3110602,100,100,0
2023,3,3110603,86,84,2
2023,3,3110604,225,230,-5
2023,3,3110605,109,99,10
2023,3,3110606,278,288,-10
2023,3,3110607,61,62,-1
2023,3,3110608,214,218,-4
2023,3,3110609,57,57,0
2023,3,3110611,107,109,-2
2023,3,3110612,269,286,-17
2023,3,3110613,42,44,-2
2023,3,3110614,172,189,-17
2023,3,3110615,133,145,-12
2023,3,3110616,40,45,-5
2023,3,3110617,90,93,-3
2023,3,3110618,215,231,-16
2023,3,3110619,80,87,-7
2023,3,3110620,366,380,-14
2023,3,3110621,72,74,-2
2023,3,3110622,167,166,1
2023,3,3110624,56,56,0
2023,3,3110625,387,390,-3
2023,3,3110626,180,183,-3
2023,3,3110627,263,260,3
2023,3,3110628,68,69,-1
2023,3,3110629,24,26,-2
2023,3,3110630,245,258,-13
2023,3,3110631,94,97,-3
2023,3,3110632,151,157,-6
2023,3,3110633,84,92,-8
2023,3,3110634,436,448,-12
2023,3,3110635,143,146,-3
2023,3,3110636,105,102,3
2023,3,3110637,105,115,-10
2023,3,3110638,443,436,7
2023,3,3110639,100,104,-4
2023,3,3110640,163,168,-5
2023,3,3110641,102,102,0
2023,3,3110643,192,204,-12
2023,3,3110644,31,32,-1
2023,3,3110645,373,365,8
2023,3,3110646,406,414,-8
2023,3,3110647,370,385,-15
2023,3,3110649,199,202,-3
2023,3,3110650,74,78,-4
2023,3,3110651,233,243,-10
2023,3,3110652,139,141,-2
2023,3,3110653,169,180,-11
2023,3,3110654,486,516,-30
2023,3,3110655,179,173,6
2023,3,3110656,480,501,-21
2023,3,3110657,386,389,-3
2023,3,3110658,151,156,-5
2023,3,3110659,509,525,-16
2023,3,3110660,560,563,-3
2023,3,3110661,44,49,-5
2023,3,3110662,334,349,-15
2023,3,3110663,91,100,-9
2023,3,3110664,73,75,-2
2023,3,3110665,282,305,-23
2023,3,3110666,35,42,-7
2023,3,3110668,337,343,-6
2023,3,3110670,162,165,-3
2023,3,3110671,393,400,-7
2023,3,3110672,67,71,-4
2023,3,3110673,241,241,0
2023,3,3110675,179,192,-13
2023,3,3110676,86,86,0
2023,3,3110677,67,70,-3
2023,3,3110678,59,61,-2
2023,3,3110679,70,69,1
2023,3,3110680,78,82,-4
2023,3,3110681,32,31,1
2023,3,3110683,27,27,0
2023,3,3110684,78,81,-3
2023,3,3110686,176,181,-5
2023,3,3110687,36,37,-1
2023,3,3110688,90,90,0
2023,3,3110689,155,156,-1
2023,3,3110690,376,381,-5
2023,3,3110691,166,166,0
2023,3,3110692,64,66,-2
2023,3,3110693,22,22,0
2023,3,3110694,255,266,-11
2023,3,3110695,303,305,-2
2023,3,3110696,69,71,-2
2023,3,3110697,94,95,-1
2023,3,3110698,126,123,3
2023,3,3110699,132,131,1
2023,3,3110700,124,132,-8
2023,3,3110701,113,113,0
2023,3,3110702,96,102,-6
2023,3,3110703,210,214,-4
2023,3,3110706,182,181,1
2023,3,3110707,133,135,-2
2023,3,3110708,61,60,1
2023,3,3110709,113,121,-8
2023,3,3110710,418,436,-18
2023,3,3110711,279,285,-6
2023,3,3110712,256,273,-17
2023,3,3110713,515,512,3
2023,3,3110714,363,375,-12
2023,3,3110715,43,42,1
2023,3,3110716,163,166,-3
2023,3,3110717,417,422,-5
2023,3,3110718,266,270,-4
2023,3,3110719,38,36,2
2023,3,3110720,232,237,-5
2023,3,3110721,127,136,-9
2023,3,3110722,136,133,3
2023,3,3110723,78,79,-1
2023,3,3110724,95,102,-7
2023,3,3110725,151,148,3
2023,3,3110726,89,93,-4
2023,3,3110727,65,71,-6
2023,3,3110728,74,78,-4
2023,3,3110729,201,209,-8
2023,3,3110730,159,160,-1
2023,3,3110731,201,200,1
2023,3,3110732,210,222,-12
2023,3,3110733,43,47,-4
2023,3,3110734,23,21,2
2023,3,3110735,217,221,-4
2023,3,3110736,228,228,0
2023,3,3110737,127,138,-11
2023,3,3110738,310,318,-8
2023,3,3110739,16,21,-5
2023,3,3110740,150,149,1
2023,3,3110741,190,205,-15
2023,3,3110742,131,131,0
2023,3,3110743,220,217,3
2023,3,3110744,316,324,-8
2023,3,3110745,162,167,-5
2023,3,3110746,109,116,-7
2023,3,3110747,89,95,-6
2023,3,3110748,105,106,-1
2023,3,3110749,203,205,-2
2023,3,3110750,167,169,-2
2023,3,3110751,150,155,-5
2023,3,3110752,240,245,-5
2023,3,3110753,229,245,-16
2023,3,3110754,157,165,-8
2023,3,3110755,161,165,-4
2023,3,3110756,110,118,-8
2023,3,3110757,236,235,1
2023,3,3110758,42,40,2
2023,3,3110760,228,224,4
2023,3,3110762,616,626,-10
2023,3,3110765,89,101,-12
2023,3,3110766,200,210,-10
2023,3,3110767,18,19,-1
2023,3,3110768,83,88,-5
2023,3,3110769,76,83,-7
2023,3,3110770,174,173,1
2023,3,3110771,51,51,0
2023,3,3110772,35,36,-1
2023,3,3110774,129,127,2
2023,3,3110775,104,101,3
2023,3,3110776,141,154,-13
2023,3,3110777,60,64,-4
2023,3,3110778,371,372,-1
2023,3,3110780,75,81,-6
2023,3,3110781,127,133,-6
2023,3,3110782,76,73,3
2023,3,3110783,129,128,1
2023,3,3110784,52,53,-1
2023,3,3110785,174,185,-11
2023,3,3110786,73,76,-3
2023,3,3110787,201,199,2
2023,3,3110788,39,42,-3
2023,3,3110789,197,196,1
2023,3,3110790,166,176,-10
2023,3,3110791,35,36,-1
2023,3,3110792,207,210,-3
2023,3,3110794,157,167,-10
2023,3,3110795,51,53,-2
2023,3,3110796,40,42,-2
2023,3,3110798,35,33,2
2023,3,3110799,23,28,-5
2023,3,3110800,39,40,-1
2023,3,3110802,101,113,-12
2023,3,3110803,150,160,-10
2023,3,3110804,142,143,-1
2023,3,3110805,48,51,-3
2023,3,3110807,88,90,-2
2023,3,3110809,67,69,-2
2023,3,3110810,261,267,-6
2023,3,3110811,92,95,-3
2023,3,3110812,105,108,-3
2023,3,3110813,296,292,4
2023,3,3110814,177,186,-9
2023,3,3110815,243,250,-7
2023,3,3110816,93,94,-1
2023,3,3110817,37,39,-2
2023,3,3110818,27,34,-7
2023,3,3110819,292,298,-6
2023,3,3110820,203,199,4
2023,3,3110821,152,157,-5
2023,3,3110822,62,63,-1
2023,3,3110823,105,102,3
2023,3,3110824,79,82,-3
2023,3,3110825,207,226,-19
2023,3,3110826,212,222,-10
2023,3,3110827,133,129,4
2023,3,3110828,280,298,-18
2023,3,3110829,61,69,-8
2023,3,3110830,90,97,-7
2023,3,3110831,98,104,-6
2023,3,3110832,129,125,4
2023,3,3110833,134,130,4
2023,3,3110835,77,79,-2
2023,3,3110836,463,474,-11
2023,3,3110837,240,242,-2
2023,3,3110838,52,53,-1
2023,3,3110839,216,210,6
2023,3,3110840,190,194,-4
2023,3,3110841,27,41,-14
2023,3,3110842,150,153,-3
2023,3,3110843,78,83,-5
2023,3,3110845,47,48,-1
2023,3,3110846,376,380,-4
2023,3,3110847,64,71,-7
2023,3,3110848,184,187,-3
2023,3,3110849,174,175,-1
2023,3,3110850,479,483,-4
2023,3,3110851,101,104,-3
2023,3,3110852,116,118,-2
2023,3,3110853,88,88,0
2023,3,3110854,69,69,0
2023,3,3110855,358,387,-29
2023,3,3110856,233,233,0
2023,3,3110857,152,152,0
2023,3,3110858,84,84,0
2023,3,3110859,74,79,-5
2023,3,3110860,106,113,-7
2023,3,3110861,451,468,-17
2023,3,3110862,94,92,2
2023,3,3110863,187,187,0
2023,3,3110864,109,118,-9
2023,3,3110865,325,333,-8
2023,3,3110866,133,145,-12
2023,3,3110867,126,135,-9
2023,3,3110868,146,149,-3
2023,3,3110869,399,417,-18
2023,3,3110871,162,166,-4
2023,3,3110872,52,57,-5
2023,3,3110873,277,276,1
2023,3,3110874,91,100,-9
2023,3,3110875,71,78,-7
2023,3,3110876,133,139,-6
2023,3,3110877,203,209,-6
2023,3,3110878,39,40,-1
2023,3,3110879,86,82,4
2023,3,3110880,46,51,-5
2023,3,3110881,597,638,-41
2023,3,3110882,225,229,-4
2023,3,3110883,240,253,-13
2023,3,3110884,120,116,4
2023,3,3110885,187,196,-9
2023,3,3110886,117,128,-11
2023,3,3110887,44,46,-2
2023,3,3110888,139,136,3
2023,3,3110889,70,67,3
2023,3,3110890,154,151,3
2023,3,3110891,130,136,-6
2023,3,3110892,528,535,-7
2023,3,3110893,24,25,-1
2023,3,3110895,562,560,2
2023,3,3110896,123,123,0
2023,3,3110897,200,204,-4
2023,3,3110899,64,74,-10
2023,3,3110900,176,183,-7
2023,3,3110901,128,131,-3
2023,3,3110902,377,369,8
2023,3,3110903,227,224,3
2023,3,3110904,161,164,-3
2023,3,3110905,100,97,3
2023,3,3110906,57,57,0
2023,3,3110907,302,301,1
2023,3,3110908,202,225,-23
2023,3,3110910,74,73,1
2023,3,3110912,128,130,-2
2023,3,3110913,154,161,-7
2023,3,3110915,90,88,2
2023,3,3110916,167,172,-5
2023,3,3110917,45,44,1
2023,3,3110918,123,122,1
2023,3,3110919,104,106,-2
2023,3,3110921,59,59,0
2023,3,3110922,65,68,-3
2023,3,3110924,87,86,1
2023,3,3110925,112,120,-8
2023,3,3110926,144,143,1
2023,3,3110929,204,206,-2
2023,3,3110930,91,95,-4
2023,3,3110931,32,37,-5
2023,3,3110932,54,55,-1
2023,3,3110934,212,218,-6
2023,3,3110935,68,74,-6
2023,3,3110936,82,84,-2
2023,3,3110939,577,608,-31
2023,3,3110940,66,70,-4
2023,3,3110942,444,454,-10
2023,3,3110943,160,169,-9
2023,3,3110945,23,19,4
2023,3,3110947,23,23,0
2023,3,3110949,153,155,-2
2023,3,3110951,96,93,3
2023,3,3110952,39,39,0
2023,3,3110953,86,88,-2
2023,3,3110954,41,41,0
2023,3,3110955,425,445,-20
2023,3,3110956,61,54,7
2023,3,3110957,291,341,-50
2023,3,3110958,108,110,-2
2023,3,3110959,33,34,-1
2023,3,3110961,151,169,-18
2023,3,3110966,339,342,-3
2023,3,3110967,122,127,-5
2023,3,3110968,61,61,0
2023,3,3110969,86,86,0
2023,3,3110970,69,64,5
2023,3,3110971,162,171,-9
2023,3,3110972,59,61,-2
2023,3,3110973,157,167,-10
2023,3,3110974,67,69,-2
2023,3,3110975,48,50,-2
2023,3,3110976,169,181,-12
2023,3,3110979,63,59,4
2023,3,3110980,109,107,2
2023,3,3110981,193,201,-8
2023,3,3110982,85,88,-3
2023,3,3110983,111,108,3
2023,3,3110984,312,315,-3
2023,3,3110988,60,58,2
2023,3,3110989,105,110,-5
2023,3,3110992,384,382,2
2023,3,3110994,252,242,10
2023,3,3110995,103,101,2
2023,3,3110996,114,107,7
2023,3,3110997,607,626,-19
2023,3,3110999,116,120,-4
2023,3,3111001,71,61,10
2023,3,3111003,548,567,-19
2023,3,3111004,630,656,-26
2023,3,3111005,292,308,-16
2023,3,3111006,451,461,-10
2023,3,3111007,238,256,-18
2023,3,3111008,233,240,-7
2023,3,3111009,100,97,3
2023,3,3111010,432,441,-9
2023,3,3111011,106,110,-4
2023,3,3111012,263,279,-16
2023,3,3111013,592,586,6
2023,3,3111014,154,162,-8
2023,3,3111015,416,427,-11
2023,3,3111016,163,170,-7
2023,3,3111017,70,70,0
2023,3,3111019,311,314,-3
2023,3,3111020,138,142,-4
2023,3,3111021,692,703,-11
2023,3,3111022,95,97,-2
2023,3,3111023,151,153,-2
2023,3,3111024,81,79,2
2023,3,3111025,122,123,-1
2023,3,3111026,278,290,-12
2023,3,3111027,308,323,-15
2023,3,3111028,167,169,-2
2023,3,3111029,92,89,3
2023,3,3111030,180,182,-2
2023,3,3111031,151,151,0
2023,3,3111032,193,200,-7
2023,3,3111033,59,60,-1
2023,3,3111034,222,229,-7
2023,3,3111035,125,131,-6
2023,3,3111036,58,59,-1
2023,3,3111037,46,43,3
2023,3,3111038,164,164,0
2023,3,3111039,137,139,-2
2023,3,3111040,60,64,-4
2023,3,3111042,273,286,-13
2023,3,3111043,59,60,-1
2023,3,3111044,271,283,-12
2023,3,3111045,42,44,-2
2023,3,3111046,483,498,-15
2023,3,3111047,80,80,0
2023,3,3111049,204,209,-5
2023,3,3111051,324,324,0
2023,3,3111052,291,288,3
2023,3,3111053,243,249,-6
2023,3,3111054,50,50,0
2023,3,3111055,29,29,0
2023,3,3111056,90,91,-1
2023,3,3111057,219,230,-11
2023,3,3111058,84,86,-2
2023,3,3111059,601,625,-24
2023,3,3111060,489,518,-29
2023,3,3111061,337,349,-12
2023,3,3111062,172,169,3
2023,3,3111063,215,215,0
2023,3,3111064,146,149,-3
2023,3,3111065,63,69,-6
2023,3,3111066,203,211,-8
2023,3,3111067,326,340,-14
2023,3,3111068,35,33,2
2023,3,3111069,130,135,-5
2023,3,3111070,67,71,-4
2023,3,3111071,41,46,-5
2023,3,3111072,220,226,-6
2023,3,3111073,368,363,5
2023,3,3111074,98,101,-3
2023,3,3111075,149,140,9
2023,3,3111076,153,159,-6
2023,3,3111077,542,561,-19
2023,3,3111078,546,545,1
2023,3,3111079,84,88,-4
2023,3,3111080,194,202,-8
2023,3,3111082,28,29,-1
2023,3,3111083,176,184,-8
2023,3,3111084,36,40,-4
2023,3,3111085,276,280,-4
2023,3,3111086,228,226,2
2023,3,3111087,103,108,-5
2023,3,3111088,165,165,0
2023,3,3111089,415,423,-8
