year_code,quarter_code,commercial_district_code,total_foot_traffic_now,total_foot_traffic_previous,traffic_diff
2022,4,3111089,863016,819807,43209
2022,4,3111088,328083,351238,-23155
2022,4,3111087,209630,196926,12704
2022,4,3111086,404289,364401,39888
2022,4,3111085,816755,866212,-49457
2022,4,3111084,191995,145633,46362
2022,4,3111083,826009,986163,-160154
2022,4,3111082,140968,187232,-46264
2022,4,3111080,572099,537061,35038
2022,4,3111079,389965,440722,-50757
2022,4,3111078,3886882,4069522,-182640
2022,4,3111077,3278410,3402608,-124198
2022,4,3111076,410794,443091,-32297
2022,4,3111075,1454400,1652788,-198388
2022,4,3111074,571031,655200,-84169
2022,4,3111073,3655168,3683696,-28528
2022,4,3111072,2064680,2146254,-81574
2022,4,3111071,562715,434003,128712
2022,4,3111070,1489531,2409687,-920156
2022,4,3111069,2530652,3093960,-563308
2022,4,3111068,277574,228552,49022
2022,4,3111067,2534000,2677021,-143021
2022,4,3111066,1299289,1310061,-10772
2022,4,3111065,580143,601025,-20882
2022,4,3111064,472038,614504,-142466
2022,4,3111063,1370687,1482390,-111703
2022,4,3111062,910924,865025,45899
2022,4,3111061,2929749,3176383,-246634
2022,4,3111060,3272129,3367532,-95403
2022,4,3111059,3340728,3484675,-143947
2022,4,3111058,498131,466366,31765
2022,4,3111057,824401,975810,-151409
2022,4,3111056,337483,322202,15281
2022,4,3111055,31957,19034,12923
2022,4,3111054,208738,134402,74336
2022,4,3111053,1108443,1148964,-40521
2022,4,3111052,1521912,1143455,378457
2022,4,3111051,2853893,2949165,-95272
2022,4,3111049,1245315,1253552,-8237
2022,4,3111047,267823,362233,-94410
2022,4,3111046,2027304,1948052,79252
2022,4,3111045,275628,280402,-4774
2022,4,3111044,1370840,1385902,-15062
2022,4,3111043,649119,797702,-148583
2022,4,3111042,2072931,1741864,331067
2022,4,3111040,698926,668473,30453
2022,4,3111039,1021221,1025052,-3831
2022,4,3111038,601179,402263,198916
2022,4,3111037,229784,230661,-877
2022,4,3111036,361827,372192,-10365
2022,4,3111035,775679,868547,-92868
2022,4,3111034,776501,827073,-50572
2022,4,3111033,51808,44698,7110
2022,4,3111032,363223,428138,-64915
2022,4,3111031,967696,980883,-13187
2022,4,3111030,1452410,1244201,208209
2022,4,3111029,196665,210795,-14130
2022,4,3111028,878403,925108,-46705
2022,4,3111027,943567,904038,39529
2022,4,3111026,936231,930260,5971
2022,4,3111025,894547,912971,-18424
2022,4,3111024,378583,394289,-15706
2022,4,3111023,906787,834813,71974
2022,4,3111022,386073,389565,-3492
2022,4,3111021,2563579,2610099,-46520
2022,4,3111020,236511,231012,5499
2022,4,3111019,1424430,1357317,67113
2022,4,3111017,171194,164809,6385
2022,4,3111016,709510,709562,-52
2022,4,3111015,1879020,1982245,-103225
2022,4,3111014,774206,677908,96298
2022,4,3111013,2417530,2314715,102815
2022,4,3111012,983880,1164085,-180205
2022,4,3111011,40721,37802,2919
2022,4,3111010,1616489,1886489,-270000
2022,4,3111009,271531,230251,41280
2022,4,3111008,726532,721066,5466
2022,4,3111007,1163401,1246056,-82655
2022,4,3111006,2007885,2297415,-289530
2022,4,3111005,1480147,1463928,16219
2022,4,3111004,2205563,2263633,-58070
2022,4,3111003,2122020,2137747,-15727
2022,4,3111001,43585,51074,-7489
2022,4,3110999,152471,151781,690
2022,4,3110997,1870798,2169539,-298741
2022,4,3110996,758383,694966,63417
2022,4,3110995,580044,607278,-27234
2022,4,3110994,447858,442313,5545
2022,4,3110992,1759645,1958770,-199125
2022,4,3110989,632224,705664,-73440
2022,4,3110988,136402,122304,14098
2022,4,3110984,877250,924167,-46917
2022,4,3110983,440736,427713,13023
2022,4,3110982,344502,302160,42342
2022,4,3110981,424948,407623,17325
2022,4,3110980,531053,493799,37254
2022,4,3110979,313634,340421,-26787
2022,4,3110976,746171,675662,70509
2022,4,3110975,313767,284509,29258
2022,4,3110974,400919,450195,-49276
2022,4,3110973,1118510,1147521,-29011
2022,4,3110972,344656,346611,-1955
2022,4,3110971,784767,790989,-6222
2022,4,3110970,343313,353813,-10500
2022,4,3110969,806141,775114,31027
2022,4,3110968,297260,299612,-2352
2022,4,3110967,591089,679984,-88895
2022,4,3110966,1700978,1646418,54560
2022,4,3110961,889633,634664,254969
2022,4,3110959,110708,75312,35396
2022,4,3110958,648480,567871,80609
2022,4,3110957,855214,877561,-22347
2022,4,3110956,577145,348297,228848
2022,4,3110955,2683268,2882095,-198827
2022,4,3110954,488517,433782,54735
2022,4,3110953,396637,412098,-15461
2022,4,3110952,211687,235010,-23323
2022,4,3110951,581834,585829,-3995
2022,4,3110949,381423,355810,25613
2022,4,3110947,21803,40140,-18337
2022,4,3110945,31559,34114,-2555
2022,4,3110943,478762,515333,-36571
2022,4,3110942,1740798,1761127,-20329
2022,4,3110940,399895,384249,15646
2022,4,3110939,1969672,1915374,54298
2022,4,3110936,223111,195260,27851
2022,4,3110935,657687,529355,128332
2022,4,3110934,422249,434232,-11983
2022,4,3110932,248246,250660,-2414
2022,4,3110931,22101,20077,2024
2022,4,3110930,483709,585404,-101695
2022,4,3110929,1562290,1449976,112314
2022,4,3110926,812953,1100449,-287496
2022,4,3110925,579192,622637,-43445
2022,4,3110924,420819,449150,-28331
2022,4,3110922,864248,873065,-8817
2022,4,3110921,346101,464060,-117959
2022,4,3110919,603605,647384,-43779
2022,4,3110918,1068137,1056240,11897
2022,4,3110917,112565,114159,-1594
2022,4,3110916,739320,844951,-105631
2022,4,3110915,181561,194664,-13103
2022,4,3110913,835781,982776,-146995
2022,4,3110912,161832,223355,-61523
2022,4,3110910,392221,366675,25546
2022,4,3110908,22311,40409,-18098
2022,4,3110907,954899,837655,117244
2022,4,3110906,491948,521093,-29145
2022,4,3110905,400043,418332,-18289
2022,4,3110904,299338,243984,55354
2022,4,3110903,796434,823951,-27517
2022,4,3110902,2366351,2245023,121328
2022,4,3110901,1226563,1141020,85543
2022,4,3110900,1821303,1871516,-50213
2022,4,3110899,881176,916813,-35637
2022,4,3110897,1531350,1495090,36260
2022,4,3110896,199060,193208,5852
2022,4,3110895,3843338,3938762,-95424
2022,4,3110893,89581,88835,746
2022,4,3110892,4503641,4676409,-172768
2022,4,3110891,215345,157501,57844
2022,4,3110890,831924,836152,-4228
2022,4,3110889,490975,493904,-2929
2022,4,3110888,724456,697771,26685
2022,4,3110887,541760,431919,109841
2022,4,3110886,1140933,1125006,15927
2022,4,3110885,1479045,1542428,-63383
2022,4,3110884,753940,728326,25614
2022,4,3110883,1242977,1096964,146013
2022,4,3110882,1668919,1676894,-7975
2022,4,3110881,4233725,4080924,152801
2022,4,3110880,492833,507869,-15036
2022,4,3110879,285055,285612,-557
2022,4,3110878,653750,852938,-199188
2022,4,3110877,1332385,1328994,3391
2022,4,3110876,534416,513792,20624
2022,4,3110875,152110,181454,-29344
2022,4,3110874,1857520,1952513,-94993
2022,4,3110873,607580,621584,-14004
2022,4,3110872,920106,860069,60037
2022,4,3110871,770724,735131,35593
2022,4,3110869,4243695,4276041,-32346
2022,4,3110868,728048,808641,-80593
2022,4,3110867,1243808,1267205,-23397
2022,4,3110866,1254408,1302195,-47787
2022,4,3110865,2395157,2336133,59024
2022,4,3110864,1531686,1826602,-294916
2022,4,3110863,801918,931544,-129626
2022,4,3110862,409537,759962,-350425
2022,4,3110861,2041931,2006088,35843
2022,4,3110860,482868,470678,12190
2022,4,3110859,548656,586170,-37514
2022,4,3110858,629327,501948,127379
2022,4,3110857,1132823,1138167,-5344
2022,4,3110856,835019,855650,-20631
2022,4,3110855,1013672,1297288,-283616
2022,4,3110854,428460,389123,39337
2022,4,3110853,1782390,1531436,250954
2022,4,3110852,696344,720593,-24249
2022,4,3110851,1173490,998565,174925
2022,4,3110850,2561136,2412562,148574
2022,4,3110849,2101120,1830075,271045
2022,4,3110848,1288391,1517993,-229602
2022,4,3110847,802199,881655,-79456
2022,4,3110846,2608182,2855350,-247168
2022,4,3110845,382895,442874,-59979
2022,4,3110843,498170,459442,38728
2022,4,3110842,173070,149833,23237
2022,4,3110841,1119325,1476479,-357154
2022,4,3110840,1216624,775159,441465
2022,4,3110839,846028,681406,164622
2022,4,3110838,140439,136736,3703
2022,4,3110837,1746747,1896215,-149468
2022,4,3110836,1503815,1515417,-11602
2022,4,3110835,197660,147045,50615
2022,4,3110833,641701,568988,72713
2022,4,3110832,599736,571402,28334
2022,4,3110831,562511,535959,26552
2022,4,3110830,584694,594345,-9651
2022,4,3110829,764460,791760,-27300
2022,4,3110828,1733473,1805080,-71607
2022,4,3110827,530089,591449,-61360
2022,4,3110826,697268,729558,-32290
2022,4,3110825,2095170,1997829,97341
2022,4,3110824,201581,254429,-52848
2022,4,3110823,759148,675198,83950
2022,4,3110822,611208,580838,30370
2022,4,3110821,1431089,1351209,79880
2022,4,3110820,855746,884174,-28428
2022,4,3110819,936137,1028910,-92773
2022,4,3110818,302423,100164,202259
2022,4,3110817,379938,328015,51923
2022,4,3110816,947127,730810,216317
2022,4,3110815,1137636,1492977,-355341
2022,4,3110814,1258180,1392830,-134650
2022,4,3110813,1271843,1336169,-64326
2022,4,3110812,632185,605202,26983
2022,4,3110811,434718,416839,17879
2022,4,3110810,1546673,1711314,-164641
2022,4,3110809,445227,395527,49700
2022,4,3110807,503903,458471,45432
2022,4,3110805,319584,345055,-25471
2022,4,3110804,880271,876797,3474
2022,4,3110803,1284837,1372767,-87930
2022,4,3110802,585982,586368,-386
2022,4,3110800,143057,147572,-4515
2022,4,3110799,173562,168618,4944
2022,4,3110798,130746,138172,-7426
2022,4,3110796,91809,89034,2775
2022,4,3110795,1089302,1151815,-62513
2022,4,3110794,994059,789787,204272
2022,4,3110792,2017012,2291397,-274385
2022,4,3110791,122128,75873,46255
2022,4,3110790,701176,756698,-55522
2022,4,3110789,529386,582641,-53255
2022,4,3110788,87422,80331,7091
2022,4,3110787,1307432,1264275,43157
2022,4,3110786,415904,408121,7783
2022,4,3110785,1115713,1118269,-2556
2022,4,3110784,192761,186839,5922
2022,4,3110783,265830,221431,44399
2022,4,3110782,192585,186056,6529
2022,4,3110781,1334180,1348469,-14289
2022,4,3110780,348164,318168,29996
2022,4,3110778,1288226,1289353,-1127
2022,4,3110777,291533,258261,33272
2022,4,3110776,812381,831175,-18794
2022,4,3110775,286110,271605,14505
2022,4,3110774,460275,468164,-7889
2022,4,3110772,312591,335575,-22984
2022,4,3110771,417394,351953,65441
2022,4,3110770,665109,703222,-38113
2022,4,3110769,599795,479226,120569
2022,4,3110768,255144,204840,50304
2022,4,3110767,227439,261160,-33721
2022,4,3110766,1259518,1222639,36879
2022,4,3110765,347400,321389,26011
2022,4,3110762,1751218,1814086,-62868
2022,4,3110760,813759,759039,54720
2022,4,3110758,340123,366816,-26693
2022,4,3110757,205456,210034,-4578
2022,4,3110756,210941,224088,-13147
2022,4,3110755,253234,260980,-7746
2022,4,3110754,1486602,1453144,33458
2022,4,3110753,908217,1062992,-154775
2022,4,3110752,767508,800046,-32538
2022,4,3110751,1028298,1045762,-17464
2022,4,3110750,777379,797526,-20147
2022,4,3110749,577054,603683,-26629
2022,4,3110748,385414,382160,3254
2022,4,3110747,162025,205487,-43462
2022,4,3110746,196261,233751,-37490
2022,4,3110745,410328,489332,-79004
2022,4,3110744,1604590,1737412,-132822
2022,4,3110743,813997,990525,-176528
2022,4,3110742,73183,67314,5869
2022,4,3110741,558853,666616,-107763
2022,4,3110740,1616602,1579707,36895
2022,4,3110739,28299,26940,1359
2022,4,3110738,802216,896535,-94319
2022,4,3110737,1374786,1533147,-158361
2022,4,3110736,825078,751539,73539
2022,4,3110735,1058896,1129192,-70296
2022,4,3110734,36760,19200,17560
2022,4,3110733,278555,245116,33439
2022,4,3110732,438017,394039,43978
2022,4,3110731,387304,429118,-41814
2022,4,3110730,565606,505568,60038
2022,4,3110729,632528,591306,41222
2022,4,3110728,186798,185904,894
2022,4,3110727,387224,331511,55713
2022,4,3110726,419449,244717,174732
2022,4,3110725,189610,212147,-22537
2022,4,3110724,595551,613215,-17664
2022,4,3110723,314760,297162,17598
2022,4,3110722,336937,340129,-3192
2022,4,3110721,1150143,1128975,21168
2022,4,3110720,994201,1013050,-18849
2022,4,3110719,325691,262309,63382
2022,4,3110718,932089,976875,-44786
2022,4,3110717,2986653,3064509,-77856
2022,4,3110716,402258,406583,-4325
2022,4,3110715,322324,289416,32908
2022,4,3110714,1488565,1496132,-7567
2022,4,3110713,2812716,2789914,22802
2022,4,3110712,2157042,2137825,19217
2022,4,3110711,1320590,1298913,21677
2022,4,3110710,2403459,2359430,44029
2022,4,3110709,1228414,1294926,-66512
2022,4,3110708,385262,322704,62558
2022,4,3110707,1081956,1139344,-57388
2022,4,3110706,273922,266704,7218
2022,4,3110703,686331,602828,83503
2022,4,3110702,832611,873772,-41161
2022,4,3110701,679474,714054,-34580
2022,4,3110700,954307,1024715,-70408
2022,4,3110699,497743,511232,-13489
2022,4,3110698,682035,718595,-36560
2022,4,3110697,483948,611885,-127937
2022,4,3110696,595405,660658,-65253
2022,4,3110695,1586233,1598183,-11950
2022,4,3110694,1885279,1871628,13651
2022,4,3110693,111380,91740,19640
2022,4,3110692,870253,1051688,-181435
2022,4,3110691,698070,722304,-24234
2022,4,3110690,1925372,1947073,-21701
2022,4,3110689,716872,674363,42509
2022,4,3110688,897910,949050,-51140
2022,4,3110687,57482,179731,-122249
2022,4,3110686,1007646,749527,258119
2022,4,3110684,65080,46266,18814
2022,4,3110683,264146,278520,-14374
2022,4,3110681,28212,32486,-4274
2022,4,3110680,214876,244196,-29320
2022,4,3110679,228770,253701,-24931
2022,4,3110678,208503,168673,39830
2022,4,3110677,202015,184301,17714
2022,4,3110676,440091,472817,-32726
2022,4,3110675,1642030,1747483,-105453
2022,4,3110673,700539,609635,90904
2022,4,3110672,740742,697839,42903
2022,4,3110671,2019774,2165529,-145755
2022,4,3110670,1498675,1583226,-84551
2022,4,3110668,1504141,1782314,-278173
2022,4,3110666,232287,193747,38540
2022,4,3110665,1963469,1101844,861625
2022,4,3110664,253123,232633,20490
2022,4,3110663,264013,262924,1089
2022,4,3110662,2336344,2673298,-336954
2022,4,3110661,321962,288527,33435
2022,4,3110660,733448,679992,53456
2022,4,3110659,4765714,5031947,-266233
2022,4,3110658,724125,899910,-175785
2022,4,3110657,615474,675157,-59683
2022,4,3110656,6375645,5826746,548899
2022,4,3110655,340482,375644,-35162
2022,4,3110654,2354764,2397872,-43108
2022,4,3110653,952689,946739,5950
2022,4,3110652,319614,296504,23110
2022,4,3110651,501215,533767,-32552
2022,4,3110650,70184,81172,-10988
2022,4,3110649,986095,1000753,-14658
2022,4,3110647,2483780,2484490,-710
2022,4,3110646,1842419,1800069,42350
2022,4,3110645,1300472,1353910,-53438
2022,4,3110644,92522,97550,-5028
2022,4,3110643,547492,781069,-233577
2022,4,3110641,268487,214950,53537
2022,4,3110640,595356,592831,2525
2022,4,3110639,657360,397902,259458
2022,4,3110638,2201678,2239830,-38152
2022,4,3110637,189994,200833,-10839
2022,4,3110636,617076,658115,-41039
2022,4,3110635,224438,282600,-58162
2022,4,3110634,2050353,1987208,63145
2022,4,3110633,48996,55834,-6838
2022,4,3110632,652962,716099,-63137
2022,4,3110631,603214,587816,15398
2022,4,3110630,1717800,1750123,-32323
2022,4,3110629,142810,163156,-20346
2022,4,3110628,296435,275826,20609
2022,4,3110627,1421805,1274701,147104
2022,4,3110626,1471624,1466296,5328
2022,4,3110625,867371,585926,281445
2022,4,3110624,528896,501707,27189
2022,4,3110622,522093,486430,35663
2022,4,3110621,175874,263229,-87355
2022,4,3110620,2055258,2283278,-228020
2022,4,3110619,368625,330574,38051
2022,4,3110618,1673105,1558254,114851
2022,4,3110617,453505,558050,-104545
2022,4,3110616,266699,242288,24411
2022,4,3110615,267779,213927,53852
2022,4,3110614,375060,519334,-144274
2022,4,3110613,213975,269272,-55297
2022,4,3110612,2043477,2183840,-140363
2022,4,3110611,1214967,1171650,43317
2022,4,3110609,864778,980161,-115383
2022,4,3110608,1384521,1593343,-208822
2022,4,3110607,172905,161007,11898
2022,4,3110606,1397635,1446911,-49276
2022,4,3110605,46902,43447,3455
2022,4,3110604,981891,1140834,-158943
2022,4,3110603,89789,87390,2399
2022,4,3110602,190162,189293,869
2022,4,3110601,1438787,1402469,36318
2022,4,3110600,447616,562895,-115279
2022,4,3110599,897114,1114908,-217794
2022,4,3110598,569552,557059,12493
2022,4,3110597,1115570,1211948,-96378
2022,4,3110596,627671,621849,5822
2022,4,3110595,587466,556857,30609
2022,4,3110594,354556,371110,-16554
2022,4,3110593,995325,1143831,-148506
2022,4,3110592,240979,243174,-2195
2022,4,3110591,1197756,1493609,-295853
2022,4,3110590,1638799,1493486,145313
2022,4,3110589,133626,101007,32619
2022,4,3110588,1084008,1009994,74014
2022,4,3110587,663551,868564,-205013
2022,4,3110586,1773778,1809015,-35237
2022,4,3110585,118090,127533,-9443
2022,4,3110584,104139,104192,-53
2022,4,3110583,397980,390560,7420
2022,4,3110582,509930,511010,-1080
2022,4,3110580,759609,747313,12296
2022,4,3110579,336721,304293,32428
2022,4,3110578,2599316,1254997,1344319
2022,4,3110577,578249,613242,-34993
2022,4,3110576,1274964,1197909,77055
2022,4,3110575,1096987,1041828,55159
2022,4,3110574,59099,51038,8061
2022,4,3110573,116229,94684,21545
2022,4,3110572,1920011,1829411,90600
2022,4,3110571,489033,509354,-20321
2022,4,3110570,175658,204799,-29141
2022,4,3110569,887443,942951,-55508
2022,4,3110568,279856,310571,-30715
2022,4,3110567,272944,278707,-5763
2022,4,3110566,1611756,1567453,44303
2022,4,3110565,456845,421510,35335
2022,4,3110564,869847,647301,222546
2022,4,3110563,175346,200420,-25074
2022,4,3110562,942349,932097,10252
2022,4,3110561,774999,742306,32693
2022,4,3110560,1045707,1134041,-88334
2022,4,3110559,893007,893765,-758
2022,4,3110558,2725317,2447611,277706
2022,4,3110557,834232,918375,-84143
2022,4,3110555,201971,194341,7630
2022,4,3110554,974051,882994,91057
2022,4,3110553,994938,769881,225057
2022,4,3110552,764306,788317,-24011
2022,4,3110551,1404084,1419328,-15244
2022,4,3110550,1754809,1729893,24916
2022,4,3110549,972075,1239476,-267401
2022,4,3110548,1204419,1125893,78526
2022,4,3110547,806641,823792,-17151
2022,4,3110546,733635,766607,-32972
2022,4,3110545,566761,582996,-16235
2022,4,3110544,4938281,5126903,-188622
2022,4,3110543,136783,87921,48862
2022,4,3110542,1404563,1568788,-164225
2022,4,3110541,1098592,1359142,-260550
2022,4,3110540,580865,559754,21111
2022,4,3110539,279045,274424,4621
2022,4,3110538,359732,380774,-21042
2022,4,3110537,466860,438003,28857
2022,4,3110536,114780,104733,10047
2022,4,3110535,1112507,1094587,17920
2022,4,3110534,591684,641858,-50174
2022,4,3110533,4825564,4441785,383779
2022,4,3110532,1094635,1050872,43763
2022,4,3110529,1102457,1008786,93671
2022,4,3110528,896537,950561,-54024
2022,4,3110527,512480,498355,14125
2022,4,3110526,150388,132204,18184
2022,4,3110525,333517,342335,-8818
2022,4,3110524,161778,129839,31939
2022,4,3110523,76167,106446,-30279
2022,4,3110522,235783,209341,26442
2022,4,3110521,628299,668000,-39701
2022,4,3110520,615198,507241,107957
2022,4,3110519,1245726,1115343,130383
2022,4,3110517,184536,168997,15539
2022,4,3110515,487999,372600,115399
2022,4,3110514,773776,670598,103178
2022,4,3110513,197606,351553,-153947
2022,4,3110512,492026,515916,-23890
2022,4,3110511,953274,877387,75887
2022,4,3110510,900592,994831,-94239
2022,4,3110509,884422,914307,-29885
2022,4,3110508,531255,512726,18529
2022,4,3110507,1790735,1484525,306210
2022,4,3110506,248463,247512,951
2022,4,3110505,52768,64709,-11941
2022,4,3110503,2060779,1758088,302691
2022,4,3110502,1388242,1670468,-282226
2022,4,3110501,187585,259776,-72191
2022,4,3110500,26356,232932,-206576
2022,4,3110499,2321963,2396846,-74883
2022,4,3110498,1881910,1740526,141384
2022,4,3110496,914196,1040977,-126781
2022,4,3110495,1011939,1317066,-305127
2022,4,3110493,327100,425577,-98477
2022,4,3110491,78150,72803,5347
2022,4,3110490,576971,632219,-55248
2022,4,3110489,428147,481192,-53045
2022,4,3110488,426659,524320,-97661
2022,4,3110487,156352,129007,27345
2022,4,3110486,605312,559190,46122
2022,4,3110485,489899,586891,-96992
2022,4,3110484,1640756,1729526,-88770
2022,4,3110483,670876,665717,5159
2022,4,3110482,345514,303774,41740
2022,4,3110481,2785941,2103542,682399
2022,4,3110480,407225,408320,-1095
2022,4,3110479,1083564,1175605,-92041
2022,4,3110478,326283,533353,-207070
2022,4,3110477,361070,364972,-3902
2022,4,3110476,145048,136642,8406
2022,4,3110475,665283,710401,-45118
2022,4,3110474,982214,1084581,-102367
2022,4,3110473,1782251,1796151,-13900
2022,4,3110472,1043509,1150732,-107223
2022,4,3110471,1510535,1581827,-71292
2022,4,3110470,621374,643622,-22248
2022,4,3110469,1708527,1619088,89439
2022,4,3110468,3317738,3257986,59752
2022,4,3110467,645905,966114,-320209
2022,4,3110466,970536,1041119,-70583
2022,4,3110465,1609098,1358700,250398
2022,4,3110464,495447,499463,-4016
2022,4,3110463,641822,565960,75862
2022,4,3110462,768938,1085905,-316967
2022,4,3110461,233632,229144,4488
2022,4,3110460,1627462,1669234,-41772
2022,4,3110459,945719,942070,3649
2022,4,3110458,949468,1210712,-261244
2022,4,3110457,807189,779262,27927
2022,4,3110456,1594227,1566848,27379
2022,4,3110455,1576217,1673233,-97016
2022,4,3110454,1287661,1345366,-57705
2022,4,3110453,1797521,1881200,-83679
2022,4,3110452,716495,941389,-224894
2022,4,3110451,1114295,1415372,-301077
2022,4,3110450,1708207,1915805,-207598
2022,4,3110449,943686,992141,-48455
2022,4,3110448,440147,647049,-206902
2022,4,3110447,489907,525234,-35327
2022,4,3110446,181113,325704,-144591
2022,4,3110444,257286,111984,145302
2022,4,3110443,82305,101281,-18976
2022,4,3110442,154172,168724,-14552
2022,4,3110441,657983,670226,-12243
2022,4,3110440,343706,403360,-59654
2022,4,3110439,1118306,1146917,-28611
2022,4,3110438,1496918,1609012,-112094
2022,4,3110437,1476297,1505809,-29512
2022,4,3110436,500773,534018,-33245
2022,4,3110435,108238,103254,4984
2022,4,3110434,485495,484080,1415
2022,4,3110433,1362310,1435920,-73610
2022,4,3110432,403762,378378,25384
2022,4,3110431,503550,473564,29986
2022,4,3110429,2069558,1976129,93429
2022,4,3110428,3768178,4143995,-375817
2022,4,3110427,105397,103755,1642
2022,4,3110426,1714722,1774596,-59874
2022,4,3110425,658018,663377,-5359
2022,4,3110424,2450783,2785956,-335173
2022,4,3110423,308103,314825,-6722
2022,4,3110422,900844,907534,-6690
2022,4,3110421,354397,360521,-6124
2022,4,3110420,523156,645863,-122707
2022,4,3110419,902999,862980,40019
2022,4,3110418,834660,793076,41584
2022,4,3110417,416225,451501,-35276
2022,4,3110416,937779,940634,-2855
2022,4,3110415,1969712,2067809,-98097
2022,4,3110413,102975,115598,-12623
2022,4,3110412,155391,177722,-22331
2022,4,3110411,499451,532979,-33528
2022,4,3110410,709311,746049,-36738
2022,4,3110409,628872,709004,-80132
2022,4,3110408,394547,422559,-28012
2022,4,3110407,987108,895321,91787
2022,4,3110406,176621,216070,-39449
2022,4,3110405,1478403,1471613,6790
2022,4,3110404,3373535,3422064,-48529
2022,4,3110403,1294314,1785555,-491241
2022,4,3110402,727035,739273,-12238
2022,4,3110401,154516,211332,-56816
2022,4,3110400,1327810,1308096,19714
2022,4,3110399,1796311,1884871,-88560
2022,4,3110398,875812,868088,7724
2022,4,3110397,1685382,1760924,-75542
2022,4,3110396,927237,1059341,-132104
2022,4,3110395,307713,291389,16324
2022,4,3110394,1235091,1107679,127412
2022,4,3110393,40720,64096,-23376
2022,4,3110392,113918,154594,-40676
2022,4,3110391,530335,425758,104577
2022,4,3110390,583802,521937,61865
2022,4,3110389,412033,392421,19612
2022,4,3110388,805373,680163,125210
2022,4,3110387,1665625,1714939,-49314
2022,4,3110383,71097,114214,-43117
2022,4,3110382,603959,618401,-14442
2022,4,3110381,421775,424410,-2635
2022,4,3110380,676984,722895,-45911
2022,4,3110379,156331,156285,46
2022,4,3110378,771927,833974,-62047
2022,4,3110377,794858,694609,100249
2022,4,3110376,3064705,3309791,-245086
2022,4,3110375,645495,658778,-13283
2022,4,3110374,2572427,2591973,-19546
2022,4,3110373,1222075,1266739,-44664
2022,4,3110372,1640927,1774472,-133545
2022,4,3110371,719362,730176,-10814
2022,4,3110370,1335864,1321254,14610
2022,4,3110369,1340104,1152455,187649
2022,4,3110368,2867682,2723509,144173
2022,4,3110367,1514431,1431257,83174
2022,4,3110366,626987,626688,299
2022,4,3110365,1820408,1710501,109907
2022,4,3110364,1556977,1443783,113194
2022,4,3110363,264545,303643,-39098
2022,4,3110362,884424,890255,-5831
2022,4,3110361,891397,937817,-46420
2022,4,3110360,1188780,1301117,-112337
2022,4,3110359,1017850,1015941,1909
2022,4,3110358,957049,977190,-20141
2022,4,3110357,1027502,1076643,-49141
2022,4,3110356,1034657,1155770,-121113
2022,4,3110355,1360405,1325345,35060
2022,4,3110354,85418,83794,1624
2022,4,3110353,775216,816727,-41511
2022,4,3110352,1657522,1653650,3872
2022,4,3110351,643498,808090,-164592
2022,4,3110350,533670,539825,-6155
2022,4,3110349,638344,647303,-8959
2022,4,3110348,2179082,2198823,-19741
2022,4,3110346,739221,605227,133994
2022,4,3110345,700394,706582,-6188
2022,4,3110344,339280,357537,-18257
2022,4,3110343,896016,892619,3397
2022,4,3110342,991318,1013023,-21705
2022,4,3110341,227552,231470,-3918
2022,4,3110340,362136,306475,55661
2022,4,3110337,462128,480429,-18301
2022,4,3110336,376624,334885,41739
2022,4,3110335,1265034,1437829,-172795
2022,4,3110334,2253142,1724591,528551
2022,4,3110333,663599,778115,-114516
2022,4,3110332,285322,220549,64773
2022,4,3110331,1185952,1202024,-16072
2022,4,3110330,862329,936425,-74096
2022,4,3110329,559422,367426,191996
2022,4,3110328,1056971,1062365,-5394
2022,4,3110327,975497,916938,58559
2022,4,3110326,459607,522162,-62555
2022,4,3110325,1049655,1060133,-10478
2022,4,3110323,1548969,1562920,-13951
2022,4,3110322,753066,815333,-62267
2022,4,3110320,193077,193670,-593
2022,4,3110319,1169653,1156659,12994
2022,4,3110318,1200305,1052325,147980
2022,4,3110317,780069,662949,117120
2022,4,3110316,2989901,2920913,68988
2022,4,3110315,1630055,1633806,-3751
2022,4,3110314,758909,745701,13208
2022,4,3110313,1778888,1352871,426017
2022,4,3110312,537566,548163,-10597
2022,4,3110310,39136,31572,7564
2022,4,3110309,390715,375197,15518
2022,4,3110308,1094507,761377,333130
2022,4,3110307,719975,676953,43022
2022,4,3110306,176591,91882,84709
2022,4,3110305,2018732,1898936,119796
2022,4,3110304,1049431,866106,183325
2022,4,3110303,1420820,1378615,42205
2022,4,3110302,284560,250405,34155
2022,4,3110301,1622574,1594589,27985
2022,4,3110300,2861900,3000306,-138406
2022,4,3110299,1894402,1898634,-4232
2022,4,3110298,326563,333649,-7086
2022,4,3110297,2431987,1995978,436009
2022,4,3110296,948400,983968,-35568
2022,4,3110295,929627,925523,4104
2022,4,3110294,1549453,1598052,-48599
2022,4,3110293,1479167,1467075,12092
2022,4,3110292,312024,318463,-6439
2022,4,3110291,2162509,2235820,-73311
2022,4,3110290,202473,209063,-6590
2022,4,3110289,1425253,1439279,-14026
2022,4,3110288,281943,328678,-46735
2022,4,3110287,246687,221357,25330
2022,4,3110286,738270,676833,61437
2022,4,3110285,146897,133688,13209
2022,4,3110284,83246,96847,-13601
2022,4,3110283,147787,160998,-13211
2022,4,3110282,42483,38269,4214
2022,4,3110281,70393,81150,-10757
2022,4,3110280,268269,284561,-16292
2022,4,3110278,802622,837344,-34722
2022,4,3110277,860020,1254368,-394348
2022,4,3110276,46632,51385,-4753
2022,4,3110275,584183,453709,130474
2022,4,3110274,1240638,1264153,-23515
2022,4,3110273,784130,765854,18276
2022,4,3110272,1278641,1239076,39565
2022,4,3110271,50343,48844,1499
2022,4,3110270,314553,456750,-142197
2022,4,3110269,487150,464649,22501
2022,4,3110268,564703,516772,47931
2022,4,3110267,1318927,1449960,-131033
2022,4,3110266,1600933,1642956,-42023
2022,4,3110265,519762,490167,29595
2022,4,3110264,2941336,3077103,-135767
2022,4,3110263,1339331,1515449,-176118
2022,4,3110262,1905484,1744399,161085
2022,4,3110261,1514941,1531579,-16638
2022,4,3110260,1478695,1508210,-29515
2022,4,3110259,1645973,1428869,217104
2022,4,3110258,739536,644936,94600
2022,4,3110257,1980654,1993676,-13022
2022,4,3110256,1666300,1686913,-20613
2022,4,3110255,2021725,1989095,32630
2022,4,3110254,3345656,3741993,-396337
2022,4,3110253,818541,826748,-8207
2022,4,3110252,1020217,891172,129045
2022,4,3110251,694051,660853,33198
2022,4,3110250,505028,457986,47042
2022,4,3110249,1939863,2188222,-248359
2022,4,3110248,539940,566898,-26958
2022,4,3110247,2241348,2198058,43290
2022,4,3110246,1449563,1337986,111577
2022,4,3110245,551998,551260,738
2022,4,3110244,1110071,957239,152832
2022,4,3110243,694906,1054400,-359494
2022,4,3110242,516711,771474,-254763
2022,4,3110241,1033107,1157164,-124057
2022,4,3110240,678468,732342,-53874
2022,4,3110238,100469,90792,9677
2022,4,3110237,939856,1044658,-104802
2022,4,3110236,1906638,2005544,-98906
2022,4,3110234,321431,316726,4705
2022,4,3110233,1215714,1254411,-38697
2022,4,3110232,830719,883996,-53277
2022,4,3110230,1082105,1049429,32676
2022,4,3110229,1839754,1826770,12984
2022,4,3110228,1570533,1618831,-48298
2022,4,3110227,505048,620480,-115432
2022,4,3110226,2697946,2488982,208964
2022,4,3110225,289533,409572,-120039
2022,4,3110224,666089,603685,62404
2022,4,3110221,284347,254168,30179
2022,4,3110220,1269634,1138248,131386
2022,4,3110219,1572033,1706423,-134390
2022,4,3110218,1328624,1251356,77268
2022,4,3110217,601766,625086,-23320
2022,4,3110216,330279,340763,-10484
2022,4,3110215,772244,710376,61868
2022,4,3110214,1734696,1483300,251396
2022,4,3110213,587028,545589,41439
2022,4,3110212,1049016,895595,153421
2022,4,3110211,2291767,2272396,19371
2022,4,3110210,2365404,2228489,136915
2022,4,3110209,332335,343244,-10909
2022,4,3110208,403376,379113,24263
2022,4,3110207,548223,606462,-58239
2022,4,3110206,1405359,1624479,-219120
2022,4,3110205,2321541,1999843,321698
2022,4,3110204,1316234,1484050,-167816
2022,4,3110203,550371,666993,-116622
2022,4,3110201,127574,147577,-20003
2022,4,3110200,411464,440738,-29274
2022,4,3110199,224976,452125,-227149
2022,4,3110197,272846,311430,-38584
2022,4,3110195,1526043,1508190,17853
2022,4,3110194,320484,597579,-277095
2022,4,3110193,823331,740891,82440
2022,4,3110191,1884831,1144571,740260
2022,4,3110190,1034199,1377244,-343045
2022,4,3110189,971878,1055448,-83570
2022,4,3110188,795367,806050,-10683
2022,4,3110187,2535445,2813554,-278109
2022,4,3110186,158168,154418,3750
2022,4,3110185,678376,596249,82127
2022,4,3110184,289225,289733,-508
2022,4,3110183,625715,466267,159448
2022,4,3110182,934558,868257,66301
2022,4,3110181,1361396,1041450,319946
2022,4,3110180,240774,243214,-2440
2022,4,3110179,521568,549974,-28406
2022,4,3110178,327244,338545,-11301
2022,4,3110177,131418,90059,41359
2022,4,3110176,1231692,1535982,-304290
2022,4,3110175,1154951,1172201,-17250
2022,4,3110174,829626,907681,-78055
2022,4,3110173,396163,407702,-11539
2022,4,3110172,936510,807123,129387
2022,4,3110171,331542,293723,37819
2022,4,3110170,2628401,3026421,-398020
2022,4,3110169,531620,600333,-68713
2022,4,3110168,472274,462610,9664
2022,4,3110167,1766257,1848130,-81873
2022,4,3110166,1991530,2052424,-60894
2022,4,3110165,713458,735689,-22231
2022,4,3110164,460947,428676,32271
2022,4,3110163,571046,737560,-166514
2022,4,3110162,480337,525267,-44930
2022,4,3110161,778844,955014,-176170
2022,4,3110160,545553,763018,-217465
2022,4,3110159,3644852,3443534,201318
2022,4,3110158,2806449,2649907,156542
2022,4,3110157,1425907,1258107,167800
2022,4,3110156,1090534,1075205,15329
2022,4,3110155,964078,853043,111035
2022,4,3110154,1702536,2024595,-322059
2022,4,3110153,303339,296971,6368
2022,4,3110152,260903,264963,-4060
2022,4,3110151,1345879,1324362,21517
2022,4,3110150,1810028,1929040,-119012
2022,4,3110149,245706,244268,1438
2022,4,3110148,612230,497479,114751
2022,4,3110147,924927,985280,-60353
2022,4,3110146,1489245,1594941,-105696
2022,4,3110144,413451,368051,45400
2022,4,3110142,1998938,1790086,208852
2022,4,3110141,1809760,1898613,-88853
2022,4,3110140,2249987,2059379,190608
2022,4,3110139,2114037,2027370,86667
2022,4,3110138,1269220,1297670,-28450
2022,4,3110137,1548966,1397441,151525
2022,4,3110136,1215531,1260191,-44660
2022,4,3110135,248194,208898,39296
2022,4,3110134,1429978,1501879,-71901
2022,4,3110133,380658,532765,-152107
2022,4,3110132,535109,589914,-54805
2022,4,3110131,811773,830886,-19113
2022,4,3110130,506395,504050,2345
2022,4,3110129,200300,264664,-64364
2022,4,3110128,1303424,1361533,-58109
2022,4,3110127,177237,158788,18449
2022,4,3110126,350565,329719,20846
2022,4,3110125,1078379,977969,100410
2022,4,3110124,267506,572597,-305091
2022,4,3110123,846882,842714,4168
2022,4,3110122,293387,313010,-19623
2022,4,3110121,187745,138451,49294
2022,4,3110120,331861,375056,-43195
2022,4,3110118,955913,665864,290049
2022,4,3110117,504026,497338,6688
2022,4,3110116,621243,667453,-46210
2022,4,3110115,743661,1082213,-338552
2022,4,3110114,382750,454412,-71662
2022,4,3110113,167596,176133,-8537
2022,4,3110112,836509,906992,-70483
2022,4,3110110,983718,1017878,-34160
2022,4,3110109,324533,288893,35640
2022,4,3110107,62941,120550,-57609
2022,4,3110105,812232,885658,-73426
2022,4,3110104,1279112,1279412,-300
2022,4,3110103,324826,254063,70763
2022,4,3110102,591158,670364,-79206
2022,4,3110099,252098,330228,-78130
2022,4,3110098,85461,84346,1115
2022,4,3110096,261209,272375,-11166
2022,4,3110095,480098,493246,-13148
2022,4,3110093,2595248,2578156,17092
2022,4,3110092,710273,678368,31905
2022,4,3110090,618376,652065,-33689
2022,4,3110089,487759,513673,-25914
2022,4,3110088,383540,405283,-21743
2022,4,3110087,243338,273736,-30398
2022,4,3110085,1329795,1367836,-38041
2022,4,3110084,925155,890342,34813
2022,4,3110083,91744,97563,-5819
2022,4,3110082,373389,345409,27980
2022,4,3110081,1632364,1850820,-218456
2022,4,3110080,1386385,1693109,-306724
2022,4,3110079,2103831,2197133,-93302
2022,4,3110078,116571,117569,-998
2022,4,3110077,632624,531593,101031
2022,4,3110075,904223,847521,56702
2022,4,3110074,755746,771615,-15869
2022,4,3110073,250369,102845,147524
2022,4,3110071,51215,34832,16383
2022,4,3110070,47923,55306,-7383
2022,4,3110069,2488352,2450291,38061
2022,4,3110068,1769573,1623228,146345
2022,4,3110067,2404257,2500616,-96359
2022,4,3110066,1335339,1361444,-26105
2022,4,3110065,55231,59087,-3856
2022,4,3110064,1390175,1577380,-187205
2022,4,3110063,833097,911195,-78098
2022,4,3110062,790049,857616,-67567
2022,4,3110061,1289841,1318253,-28412
2022,4,3110060,606573,578117,28456
2022,4,3110059,552744,851696,-298952
2022,4,3110058,1522691,1546586,-23895
2022,4,3110057,730666,839859,-109193
2022,4,3110056,1838801,2003460,-164659
2022,4,3110055,504380,526239,-21859
2022,4,3110054,1054978,1036169,18809
2022,4,3110053,1065259,1144713,-79454
2022,4,3110052,628059,570587,57472
2022,4,3110051,964399,897154,67245
2022,4,3110050,443733,393267,50466
2022,4,3110049,739152,616703,122449
2022,4,3110048,850742,825609,25133
2022,4,3110047,618779,603369,15410
2022,4,3110045,677623,639113,38510
2022,4,3110043,836209,784513,51696
2022,4,3110042,195035,181077,13958
2022,4,3110041,333635,267660,65975
2022,4,3110040,167777,179855,-12078
2022,4,3110039,85981,93747,-7766
2022,4,3110037,877865,914304,-36439
2022,4,3110036,374214,386743,-12529
2022,4,3110035,1337837,1331369,6468
2022,4,3110033,689416,735905,-46489
2022,4,3110031,63041,59646,3395
2022,4,3110030,146722,142424,4298
2022,4,3110029,3345057,3227849,117208
2022,4,3110028,2735634,2661593,74041
2022,4,3110027,396052,380019,16033
2022,4,3110025,266935,219111,47824
2022,4,3110024,330807,317006,13801
2022,4,3110023,382157,506326,-124169
2022,4,3110022,570301,555073,15228
2022,4,3110021,1541952,1339871,202081
2022,4,3110020,2006306,1775232,231074
2022,4,3110018,502207,440696,61511
2022,4,3110017,481114,467365,13749
2022,4,3110016,40603,33070,7533
2022,4,3110014,62567,57589,4978
2022,4,3110012,617027,587325,29702
2022,4,3110010,141475,173610,-32135
2022,4,3110009,173943,176965,-3022
2022,4,3110008,1332543,1263517,69026
2022,4,3110007,881009,957226,-76217
2022,4,3110006,8585,6929,1656
2022,4,3110005,112754,121296,-8542
2022,4,3110004,547155,617670,-70515
2022,4,3110003,569772,721287,-151515
2022,4,3110002,566740,558906,7834
2022,4,3110001,163128,124555,38573
2022,3,3111089,878654,844807,33847
2022,3,3111088,321762,361195,-39433
2022,3,3111087,198694,245274,-46580
2022,3,3111086,350377,381759,-31382
2022,3,3111085,788769,898411,-109642
2022,3,3111084,187662,139131,48531
2022,3,3111083,891296,987551,-96255
2022,3,3111082,139955,188732,-48777
2022,3,3111080,526180,517064,9116
2022,3,3111079,373988,408750,-34762
2022,3,3111078,3942492,4043455,-100963
2022,3,3111077,3238965,3090095,148870
2022,3,3111076,426472,470486,-44014
2022,3,3111075,1479581,1599391,-119810
2022,3,3111074,571089,654808,-83719
2022,3,3111073,3616347,3456656,159691
2022,3,3111072,2221743,2204616,17127
2022,3,3111071,574680,420459,154221
2022,3,3111070,1339798,3105171,-1765373
2022,3,3111069,2441952,3243750,-801798
2022,3,3111068,260242,231773,28469
2022,3,3111067,2548716,2743026,-194310
2022,3,3111066,1242140,1597018,-354878
2022,3,3111065,576814,712501,-135687
2022,3,3111064,533505,608079,-74574
2022,3,3111063,1384256,1573258,-189002
2022,3,3111062,895294,826689,68605
2022,3,3111061,2994162,3098384,-104222
2022,3,3111060,3264988,3630996,-366008
2022,3,3111059,3349057,3501585,-152528
2022,3,3111058,472430,488195,-15765
2022,3,3111057,811654,925838,-114184
2022,3,3111056,346190,289662,56528
2022,3,3111055,28638,19331,9307
2022,3,3111054,204063,133877,70186
2022,3,3111053,1087203,1194337,-107134
2022,3,3111052,1544101,1088721,455380
2022,3,3111051,2835280,2987333,-152053
2022,3,3111049,1204350,1278069,-73719
2022,3,3111047,272908,500205,-227297
2022,3,3111046,2007172,2027075,-19903
2022,3,3111045,271486,264537,6949
2022,3,3111044,1431549,1381473,50076
2022,3,3111043,691984,786228,-94244
2022,3,3111042,1950369,1774771,175598
2022,3,3111040,625027,759684,-134657
2022,3,3111039,998509,925707,72802
2022,3,3111038,531114,467832,63282
2022,3,3111037,240213,240591,-378
2022,3,3111036,355861,373819,-17958
2022,3,3111035,814307,899711,-85404
2022,3,3111034,805453,815126,-9673
2022,3,3111033,46429,54699,-8270
2022,3,3111032,352244,468268,-116024
2022,3,3111031,960284,916141,44143
2022,3,3111030,1461456,1261223,200233
2022,3,3111029,178925,259589,-80664
2022,3,3111028,890770,853854,36916
2022,3,3111027,936608,1072231,-135623
2022,3,3111026,918390,951194,-32804
2022,3,3111025,800771,859613,-58842
2022,3,3111024,449227,384384,64843
2022,3,3111023,893606,786574,107032
2022,3,3111022,386375,423330,-36955
2022,3,3111021,2481161,2617360,-136199
2022,3,3111020,219125,214898,4227
2022,3,3111019,1458605,1389990,68615
2022,3,3111017,183746,194133,-10387
2022,3,3111016,707393,729587,-22194
2022,3,3111015,1962445,2018028,-55583
2022,3,3111014,713342,605083,108259
2022,3,3111013,2524585,2253262,271323
2022,3,3111012,1004349,1413730,-409381
2022,3,3111011,36391,40341,-3950
2022,3,3111010,1650793,1917656,-266863
2022,3,3111009,254918,236502,18416
2022,3,3111008,746483,729301,17182
2022,3,3111007,1191709,1283504,-91795
2022,3,3111006,2108784,2258110,-149326
2022,3,3111005,1413660,1437109,-23449
2022,3,3111004,2256460,2245836,10624
2022,3,3111003,2119812,2128531,-8719
2022,3,3111001,47124,53126,-6002
2022,3,3110999,157088,154810,2278
2022,3,3110997,1888318,2413704,-525386
2022,3,3110996,799890,698399,101491
2022,3,3110995,596736,613193,-16457
2022,3,3110994,476618,461335,15283
2022,3,3110992,2035887,2043468,-7581
2022,3,3110989,658189,698877,-40688
2022,3,3110988,124760,145199,-20439
2022,3,3110984,918569,912888,5681
2022,3,3110983,443655,451960,-8305
2022,3,3110982,357894,323642,34252
2022,3,3110981,436170,408020,28150
2022,3,3110980,518402,485552,32850
2022,3,3110979,318689,310135,8554
2022,3,3110976,746138,701956,44182
2022,3,3110975,311878,316722,-4844
2022,3,3110974,428288,492974,-64686
2022,3,3110973,1082489,1084976,-2487
2022,3,3110972,354718,324828,29890
2022,3,3110971,805553,803858,1695
2022,3,3110970,347094,388949,-41855
2022,3,3110969,790274,721917,68357
2022,3,3110968,298809,279177,19632
2022,3,3110967,667907,637363,30544
2022,3,3110966,1609358,1611365,-2007
2022,3,3110961,914569,645014,269555
2022,3,3110959,106040,103439,2601
2022,3,3110958,637015,541708,95307
2022,3,3110957,869111,815602,53509
2022,3,3110956,555959,337576,218383
2022,3,3110955,2797389,2785145,12244
2022,3,3110954,481105,383936,97169
2022,3,3110953,408958,396406,12552
2022,3,3110952,215645,226162,-10517
2022,3,3110951,594226,560541,33685
2022,3,3110949,369427,344245,25182
2022,3,3110947,33852,42686,-8834
2022,3,3110945,31197,37807,-6610
2022,3,3110943,474718,532370,-57652
2022,3,3110942,1740794,1742779,-1985
2022,3,3110940,389783,354342,35441
2022,3,3110939,1938571,1864754,73817
2022,3,3110936,206349,183222,23127
2022,3,3110935,617358,478199,139159
2022,3,3110934,434343,423708,10635
2022,3,3110932,234204,247130,-12926
2022,3,3110931,24383,16568,7815
2022,3,3110930,508408,590027,-81619
2022,3,3110929,1423029,1218587,204442
2022,3,3110926,1060237,1076422,-16185
2022,3,3110925,577780,575671,2109
2022,3,3110924,457543,564026,-106483
2022,3,3110922,829162,907635,-78473
2022,3,3110921,336319,364428,-28109
2022,3,3110919,597130,679408,-82278
2022,3,3110918,1020984,1058220,-37236
2022,3,3110917,105202,107331,-2129
2022,3,3110916,757585,773707,-16122
2022,3,3110915,177472,190939,-13467
2022,3,3110913,823410,1092542,-269132
2022,3,3110912,161702,212296,-50594
2022,3,3110910,380487,356240,24247
2022,3,3110908,22229,79226,-56997
2022,3,3110907,962160,915283,46877
2022,3,3110906,476551,532970,-56419
2022,3,3110905,419271,466483,-47212
2022,3,3110904,251832,232025,19807
2022,3,3110903,798758,864650,-65892
2022,3,3110902,2329263,2390815,-61552
2022,3,3110901,1189527,1326689,-137162
2022,3,3110900,1862998,1763943,99055
2022,3,3110899,938660,898093,40567
2022,3,3110897,1531192,1583981,-52789
2022,3,3110896,194526,188029,6497
2022,3,3110895,3738440,3760651,-22211
2022,3,3110893,79713,81031,-1318
2022,3,3110892,4624832,4706198,-81366
2022,3,3110891,181532,179602,1930
2022,3,3110890,831615,798853,32762
2022,3,3110889,501568,490429,11139
2022,3,3110888,698350,699064,-714
2022,3,3110887,530499,437853,92646
2022,3,3110886,1108675,1097666,11009
2022,3,3110885,1419285,1617165,-197880
2022,3,3110884,766202,737345,28857
2022,3,3110883,1111647,1145325,-33678
2022,3,3110882,1619239,1634810,-15571
2022,3,3110881,4216516,4037916,178600
2022,3,3110880,488719,495641,-6922
2022,3,3110879,288845,287767,1078
2022,3,3110878,700447,803204,-102757
2022,3,3110877,1329472,1301430,28042
2022,3,3110876,516442,580393,-63951
2022,3,3110875,160059,175588,-15529
2022,3,3110874,1871445,2048211,-176766
2022,3,3110873,612128,807074,-194946
2022,3,3110872,910440,822011,88429
2022,3,3110871,755239,699261,55978
2022,3,3110869,4687025,4128889,558136
2022,3,3110868,703531,815669,-112138
2022,3,3110867,1232976,1263904,-30928
2022,3,3110866,1245601,1223802,21799
2022,3,3110865,2322667,2319934,2733
2022,3,3110864,1714111,1847035,-132924
2022,3,3110863,852848,993459,-140611
2022,3,3110862,575118,765018,-189900
2022,3,3110861,2105677,1941561,164116
2022,3,3110860,485842,481852,3990
2022,3,3110859,564412,526310,38102
2022,3,3110858,488469,420340,68129
2022,3,3110857,1106186,1108652,-2466
2022,3,3110856,870193,868444,1749
2022,3,3110855,1224477,1401979,-177502
2022,3,3110854,434234,381906,52328
2022,3,3110853,1694014,1513962,180052
2022,3,3110852,752410,714817,37593
2022,3,3110851,1116445,975749,140696
2022,3,3110850,2472337,2468739,3598
2022,3,3110849,1962040,1730013,232027
2022,3,3110848,1370984,1455811,-84827
2022,3,3110847,832683,910437,-77754
2022,3,3110846,2542904,2954339,-411435
2022,3,3110845,396889,442691,-45802
2022,3,3110843,468186,480378,-12192
2022,3,3110842,167586,151126,16460
2022,3,3110841,1342257,1429743,-87486
2022,3,3110840,974151,733348,240803
2022,3,3110839,718762,671685,47077
2022,3,3110838,140204,130229,9975
2022,3,3110837,1762180,1885707,-123527
2022,3,3110836,1467268,1642201,-174933
2022,3,3110835,170783,152842,17941
2022,3,3110833,613505,539418,74087
2022,3,3110832,586121,560635,25486
2022,3,3110831,540360,530623,9737
2022,3,3110830,568068,695436,-127368
2022,3,3110829,753397,875895,-122498
2022,3,3110828,1828882,1834210,-5328
2022,3,3110827,432878,596043,-163165
2022,3,3110826,826579,783734,42845
2022,3,3110825,2075120,2164635,-89515
2022,3,3110824,195315,269057,-73742
2022,3,3110823,743899,661056,82843
2022,3,3110822,567170,603717,-36547
2022,3,3110821,1333879,1375171,-41292
2022,3,3110820,838961,836319,2642
2022,3,3110819,854092,1013999,-159907
2022,3,3110818,157849,106961,50888
2022,3,3110817,345412,315093,30319
2022,3,3110816,839329,697232,142097
2022,3,3110815,1458651,1512704,-54053
2022,3,3110814,1332780,1325532,7248
2022,3,3110813,1213483,1260404,-46921
2022,3,3110812,604784,623198,-18414
2022,3,3110811,471633,413338,58295
2022,3,3110810,1540111,1708939,-168828
2022,3,3110809,449168,420032,29136
2022,3,3110807,469671,443458,26213
2022,3,3110805,323198,322386,812
2022,3,3110804,835928,903408,-67480
2022,3,3110803,1345184,1378965,-33781
2022,3,3110802,581986,564014,17972
2022,3,3110800,151049,153709,-2660
2022,3,3110799,176884,184705,-7821
2022,3,3110798,134932,141995,-7063
2022,3,3110796,107049,87037,20012
2022,3,3110795,1090429,1134082,-43653
2022,3,3110794,837120,716315,120805
2022,3,3110792,2114712,2313233,-198521
2022,3,3110791,127018,76915,50103
2022,3,3110790,733114,888319,-155205
2022,3,3110789,585198,542724,42474
2022,3,3110788,83044,78734,4310
2022,3,3110787,1295486,1404130,-108644
2022,3,3110786,414607,402327,12280
2022,3,3110785,1087511,1142511,-55000
2022,3,3110784,198371,195322,3049
2022,3,3110783,245634,266606,-20972
2022,3,3110782,188545,231280,-42735
2022,3,3110781,1312273,1349479,-37206
2022,3,3110780,338065,311701,26364
2022,3,3110778,1267292,1574764,-307472
2022,3,3110777,264467,250506,13961
2022,3,3110776,810337,836942,-26605
2022,3,3110775,314028,208504,105524
2022,3,3110774,433953,434216,-263
2022,3,3110772,307525,326327,-18802
2022,3,3110771,430844,335396,95448
2022,3,3110770,653686,793808,-140122
2022,3,3110769,552864,452543,100321
2022,3,3110768,242815,197738,45077
2022,3,3110767,256501,252074,4427
2022,3,3110766,1201201,1160782,40419
2022,3,3110765,295713,293955,1758
2022,3,3110762,1785984,1787427,-1443
2022,3,3110760,783498,758437,25061
2022,3,3110758,339286,358520,-19234
2022,3,3110757,204574,201817,2757
2022,3,3110756,211326,235034,-23708
2022,3,3110755,257937,265147,-7210
2022,3,3110754,1488640,1299948,188692
2022,3,3110753,956666,1102313,-145647
2022,3,3110752,766550,910323,-143773
2022,3,3110751,999490,1112313,-112823
2022,3,3110750,880622,898341,-17719
2022,3,3110749,588226,564324,23902
2022,3,3110748,351975,406142,-54167
2022,3,3110747,153790,196085,-42295
2022,3,3110746,205296,267916,-62620
2022,3,3110745,422872,516413,-93541
2022,3,3110744,1612354,1817674,-205320
2022,3,3110743,899442,931504,-32062
2022,3,3110742,68803,63543,5260
2022,3,3110741,610539,675887,-65348
2022,3,3110740,1484080,1495340,-11260
2022,3,3110739,29958,26847,3111
2022,3,3110738,859673,842539,17134
2022,3,3110737,1472167,1455097,17070
2022,3,3110736,831861,750459,81402
2022,3,3110735,1048641,1182322,-133681
2022,3,3110734,25600,21903,3697
2022,3,3110733,251837,251903,-66
2022,3,3110732,381154,398358,-17204
2022,3,3110731,414066,386978,27088
2022,3,3110730,544881,485304,59577
2022,3,3110729,609462,565404,44058
2022,3,3110728,173322,188445,-15123
2022,3,3110727,384755,310867,73888
2022,3,3110726,416306,262402,153904
2022,3,3110725,206691,217063,-10372
2022,3,3110724,607832,592689,15143
2022,3,3110723,306601,280256,26345
2022,3,3110722,345798,330732,15066
2022,3,3110721,1153878,1040411,113467
2022,3,3110720,1060381,1034807,25574
2022,3,3110719,311069,249928,61141
2022,3,3110718,953026,946097,6929
2022,3,3110717,2987451,3192790,-205339
2022,3,3110716,394396,382236,12160
2022,3,3110715,284809,309757,-24948
2022,3,3110714,1518693,1497877,20816
2022,3,3110713,2864600,2787384,77216
2022,3,3110712,2148269,2148977,-708
2022,3,3110711,1296862,1217059,79803
2022,3,3110710,2365608,2435884,-70276
2022,3,3110709,1263048,1269758,-6710
2022,3,3110708,371310,329383,41927
2022,3,3110707,1050288,1136871,-86583
2022,3,3110706,282289,259743,22546
2022,3,3110703,588456,650307,-61851
2022,3,3110702,941224,882874,58350
2022,3,3110701,675381,662610,12771
2022,3,3110700,1005523,1025016,-19493
2022,3,3110699,496469,522810,-26341
2022,3,3110698,692760,712372,-19612
2022,3,3110697,511491,605586,-94095
2022,3,3110696,582387,722636,-140249
2022,3,3110695,1612448,1653051,-40603
2022,3,3110694,1825222,1944723,-119501
2022,3,3110693,97134,86926,10208
2022,3,3110692,1001387,1036121,-34734
2022,3,3110691,693652,738237,-44585
2022,3,3110690,1883607,1830428,53179
2022,3,3110689,638595,652818,-14223
2022,3,3110688,936804,943634,-6830
2022,3,3110687,53982,175498,-121516
2022,3,3110686,745001,765855,-20854
2022,3,3110684,62474,90561,-28087
2022,3,3110683,271343,279860,-8517
2022,3,3110681,28076,31127,-3051
2022,3,3110680,213793,250656,-36863
2022,3,3110679,221071,251030,-29959
2022,3,3110678,202233,179269,22964
2022,3,3110677,181505,199630,-18125
2022,3,3110676,406614,501285,-94671
2022,3,3110675,1644027,1799336,-155309
2022,3,3110673,647988,678835,-30847
2022,3,3110672,699004,658769,40235
2022,3,3110671,1999310,2161197,-161887
2022,3,3110670,1570982,1624738,-53756
2022,3,3110668,1671755,1672912,-1157
2022,3,3110666,207701,230618,-22917
2022,3,3110665,1497922,1190112,307810
2022,3,3110664,238941,219664,19277
2022,3,3110663,257221,260202,-2981
2022,3,3110662,2513205,2618038,-104833
2022,3,3110661,300706,281290,19416
2022,3,3110660,715005,585100,129905
2022,3,3110659,4834573,5156690,-322117
2022,3,3110658,765053,936254,-171201
2022,3,3110657,618913,681421,-62508
2022,3,3110656,6254408,5837436,416972
2022,3,3110655,337252,359224,-21972
2022,3,3110654,2365983,2476766,-110783
2022,3,3110653,887461,922226,-34765
2022,3,3110652,306993,298433,8560
2022,3,3110651,531615,664704,-133089
2022,3,3110650,70004,170863,-100859
2022,3,3110649,966819,1070460,-103641
2022,3,3110647,2627274,2398063,229211
2022,3,3110646,1707365,1904843,-197478
2022,3,3110645,1307265,1372293,-65028
2022,3,3110644,90571,97272,-6701
2022,3,3110643,577573,751909,-174336
2022,3,3110641,254834,190742,64092
2022,3,3110640,602532,602680,-148
2022,3,3110639,618543,412562,205981
2022,3,3110638,2179084,2077609,101475
2022,3,3110637,184785,206027,-21242
2022,3,3110636,610484,612352,-1868
2022,3,3110635,205806,263338,-57532
2022,3,3110634,2080156,2054300,25856
2022,3,3110633,52602,70680,-18078
2022,3,3110632,650000,639260,10740
2022,3,3110631,641278,664727,-23449
2022,3,3110630,1778158,1684630,93528
2022,3,3110629,145076,151634,-6558
2022,3,3110628,259445,270845,-11400
2022,3,3110627,1250151,1269049,-18898
2022,3,3110626,1528616,1419189,109427
2022,3,3110625,863618,635766,227852
2022,3,3110624,476142,570357,-94215
2022,3,3110622,461207,485441,-24234
2022,3,3110621,221703,334281,-112578
2022,3,3110620,2184377,2359822,-175445
2022,3,3110619,329178,338587,-9409
2022,3,3110618,1625553,1544050,81503
2022,3,3110617,373485,551026,-177541
2022,3,3110616,269438,226326,43112
2022,3,3110615,236985,231279,5706
2022,3,3110614,384888,586865,-201977
2022,3,3110613,226188,232885,-6697
2022,3,3110612,2088627,2386971,-298344
2022,3,3110611,1157096,1174331,-17235
2022,3,3110609,960700,986043,-25343
2022,3,3110608,1434369,1602405,-168036
2022,3,3110607,154592,163591,-8999
2022,3,3110606,1406525,1503277,-96752
2022,3,3110605,47842,64789,-16947
2022,3,3110604,1105328,1167243,-61915
2022,3,3110603,83913,84627,-714
2022,3,3110602,205437,179658,25779
2022,3,3110601,1394302,1420788,-26486
2022,3,3110600,401219,577546,-176327
2022,3,3110599,1028155,1106229,-78074
2022,3,3110598,605340,549112,56228
2022,3,3110597,1133943,1229178,-95235
2022,3,3110596,622830,610485,12345
2022,3,3110595,591322,590699,623
2022,3,3110594,316780,395634,-78854
2022,3,3110593,1061326,1200050,-138724
2022,3,3110592,245789,250720,-4931
2022,3,3110591,1312924,1453071,-140147
2022,3,3110590,1611218,1404366,206852
2022,3,3110589,118681,142622,-23941
2022,3,3110588,1052362,1106356,-53994
2022,3,3110587,674965,855049,-180084
2022,3,3110586,1802592,1681036,121556
2022,3,3110585,118955,137006,-18051
2022,3,3110584,101921,112620,-10699
2022,3,3110583,396135,395157,978
2022,3,3110582,491026,575023,-83997
2022,3,3110580,729156,715005,14151
2022,3,3110579,321474,325698,-4224
2022,3,3110578,1685088,1180811,504277
2022,3,3110577,618941,622016,-3075
2022,3,3110576,1219248,1160191,59057
2022,3,3110575,1080384,977010,103374
2022,3,3110574,49918,69528,-19610
2022,3,3110573,107740,95182,12558
2022,3,3110572,1823967,1791239,32728
2022,3,3110571,494731,540279,-45548
2022,3,3110570,192771,204850,-12079
2022,3,3110569,911551,900818,10733
2022,3,3110568,284565,303462,-18897
2022,3,3110567,270768,275640,-4872
2022,3,3110566,1596789,1487491,109298
2022,3,3110565,420798,349296,71502
2022,3,3110564,784971,554072,230899
2022,3,3110563,189713,189923,-210
2022,3,3110562,975415,1033513,-58098
2022,3,3110561,802231,736330,65901
2022,3,3110560,1048241,1084733,-36492
2022,3,3110559,910507,808776,101731
2022,3,3110558,2710783,2413776,297007
2022,3,3110557,847294,914717,-67423
2022,3,3110555,202958,186608,16350
2022,3,3110554,860226,914548,-54322
2022,3,3110553,717056,733267,-16211
2022,3,3110552,758256,851623,-93367
2022,3,3110551,1354206,1364034,-9828
2022,3,3110550,1731190,1727761,3429
2022,3,3110549,1202806,1266434,-63628
2022,3,3110548,1200404,1100195,100209
2022,3,3110547,816822,804946,11876
2022,3,3110546,779887,769784,10103
2022,3,3110545,532601,596876,-64275
2022,3,3110544,5172563,5098395,74168
2022,3,3110543,151630,87373,64257
2022,3,3110542,1487480,1574853,-87373
2022,3,3110541,1173294,1484531,-311237
2022,3,3110540,578992,626464,-47472
2022,3,3110539,277141,262797,14344
2022,3,3110538,372476,374863,-2387
2022,3,3110537,445490,408193,37297
2022,3,3110536,100223,98943,1280
2022,3,3110535,1107205,1041446,65759
2022,3,3110534,598110,604032,-5922
2022,3,3110533,4678442,4007799,670643
2022,3,3110532,1078515,1012958,65557
2022,3,3110529,1083543,1038478,45065
2022,3,3110528,861084,850210,10874
2022,3,3110527,559405,476998,82407
2022,3,3110526,137556,121435,16121
2022,3,3110525,321498,354845,-33347
2022,3,3110524,143696,122791,20905
2022,3,3110523,85871,105048,-19177
2022,3,3110522,217895,256627,-38732
2022,3,3110521,632992,655335,-22343
2022,3,3110520,597168,598877,-1709
2022,3,3110519,1304265,1119183,185082
2022,3,3110517,162689,160885,1804
2022,3,3110515,411849,317316,94533
2022,3,3110514,758529,610404,148125
2022,3,3110513,254011,327802,-73791
2022,3,3110512,485640,568214,-82574
2022,3,3110511,885766,832844,52922
2022,3,3110510,926944,993130,-66186
2022,3,3110509,935987,882384,53603
2022,3,3110508,481372,580214,-98842
2022,3,3110507,1662193,1585571,76622
2022,3,3110506,265414,212689,52725
2022,3,3110505,62348,55992,6356
2022,3,3110503,1877456,1604874,272582
2022,3,3110502,1347397,1624467,-277070
2022,3,3110501,172195,274116,-101921
2022,3,3110500,22394,242283,-219889
2022,3,3110499,2527977,2370370,157607
2022,3,3110498,1851668,1582880,268788
2022,3,3110496,896898,1009672,-112774
2022,3,3110495,958182,1337009,-378827
2022,3,3110493,418648,455036,-36388
2022,3,3110491,77801,76455,1346
2022,3,3110490,561157,663052,-101895
2022,3,3110489,424840,400929,23911
2022,3,3110488,470024,476573,-6549
2022,3,3110487,145153,124673,20480
2022,3,3110486,588073,515753,72320
2022,3,3110485,501524,657473,-155949
2022,3,3110484,1649222,1751617,-102395
2022,3,3110483,664577,644778,19799
2022,3,3110482,330391,308366,22025
2022,3,3110481,2557376,1960635,596741
2022,3,3110480,395621,500240,-104619
2022,3,3110479,1074502,1157004,-82502
2022,3,3110478,382083,645044,-262961
2022,3,3110477,353789,391619,-37830
2022,3,3110476,140829,137570,3259
2022,3,3110475,706892,708055,-1163
2022,3,3110474,948039,1000360,-52321
2022,3,3110473,1784850,1802779,-17929
2022,3,3110472,1063636,1176202,-112566
2022,3,3110471,1498840,1642760,-143920
2022,3,3110470,641732,678610,-36878
2022,3,3110469,1493864,1666586,-172722
2022,3,3110468,3378017,3214683,163334
2022,3,3110467,686216,980718,-294502
2022,3,3110466,987037,1065515,-78478
2022,3,3110465,1643036,1340303,302733
2022,3,3110464,498430,500644,-2214
2022,3,3110463,646473,529559,116914
2022,3,3110462,899038,1202239,-303201
2022,3,3110461,232665,238020,-5355
2022,3,3110460,1675276,1616467,58809
2022,3,3110459,935810,954246,-18436
2022,3,3110458,939483,1273946,-334463
2022,3,3110457,787406,766363,21043
2022,3,3110456,1604255,1590051,14204
2022,3,3110455,1564717,1663542,-98825
2022,3,3110454,1279441,1304179,-24738
2022,3,3110453,1853133,1986514,-133381
2022,3,3110452,719840,964003,-244163
2022,3,3110451,1160378,1404881,-244503
2022,3,3110450,1709927,1953717,-243790
2022,3,3110449,896854,952319,-55465
2022,3,3110448,437045,786473,-349428
2022,3,3110447,505103,512888,-7785
2022,3,3110446,260751,317539,-56788
2022,3,3110444,217624,106722,110902
2022,3,3110443,82775,118192,-35417
2022,3,3110442,162881,167355,-4474
2022,3,3110441,636253,862155,-225902
2022,3,3110440,356283,761164,-404881
2022,3,3110439,1134089,1006855,127234
2022,3,3110438,1494945,1550409,-55464
2022,3,3110437,1473599,1524297,-50698
2022,3,3110436,504246,508598,-4352
2022,3,3110435,98194,97842,352
2022,3,3110434,483063,465443,17620
2022,3,3110433,1339508,1343588,-4080
2022,3,3110432,385894,427309,-41415
2022,3,3110431,473806,478766,-4960
2022,3,3110429,2064719,2054776,9943
2022,3,3110428,3907793,4095332,-187539
2022,3,3110427,107350,152809,-45459
2022,3,3110426,1724398,1734747,-10349
2022,3,3110425,652896,834667,-181771
2022,3,3110424,2517801,2693006,-175205
2022,3,3110423,301185,284195,16990
2022,3,3110422,897345,884268,13077
2022,3,3110421,340368,408565,-68197
2022,3,3110420,529856,621335,-91479
2022,3,3110419,888918,907107,-18189
2022,3,3110418,666434,736272,-69838
2022,3,3110417,406423,440376,-33953
2022,3,3110416,928068,902244,25824
2022,3,3110415,2003128,2075598,-72470
2022,3,3110413,111566,117327,-5761
2022,3,3110412,161363,152686,8677
2022,3,3110411,624567,514706,109861
2022,3,3110410,705624,728829,-23205
2022,3,3110409,703492,749642,-46150
2022,3,3110408,403735,425561,-21826
2022,3,3110407,987693,937540,50153
2022,3,3110406,182507,226000,-43493
2022,3,3110405,1476656,1648690,-172034
2022,3,3110404,3344573,3498667,-154094
2022,3,3110403,1367029,1773927,-406898
2022,3,3110402,720554,803660,-83106
2022,3,3110401,162482,210794,-48312
2022,3,3110400,1307414,1320508,-13094
2022,3,3110399,1797624,1916214,-118590
2022,3,3110398,888246,855397,32849
2022,3,3110397,1668549,1757537,-88988
2022,3,3110396,941403,1043576,-102173
2022,3,3110395,309533,292260,17273
2022,3,3110394,1138476,1394492,-256016
2022,3,3110393,44023,64712,-20689
2022,3,3110392,146788,153726,-6938
2022,3,3110391,562070,444066,118004
2022,3,3110390,612961,620087,-7126
2022,3,3110389,379827,392406,-12579
2022,3,3110388,692849,655058,37791
2022,3,3110387,1776473,1628381,148092
2022,3,3110383,74183,190279,-116096
2022,3,3110382,610589,581280,29309
2022,3,3110381,434091,410825,23266
2022,3,3110380,693429,738269,-44840
2022,3,3110379,154928,188282,-33354
2022,3,3110378,788077,822759,-34682
2022,3,3110377,758677,681885,76792
2022,3,3110376,3242792,3924519,-681727
2022,3,3110375,604636,621268,-16632
2022,3,3110374,2500667,2701922,-201255
2022,3,3110373,1222938,1271579,-48641
2022,3,3110372,1680015,1831673,-151658
2022,3,3110371,669382,742374,-72992
2022,3,3110370,1248446,1491656,-243210
2022,3,3110369,1253758,1229120,24638
2022,3,3110368,2854251,2702152,152099
2022,3,3110367,1490714,1356589,134125
2022,3,3110366,626537,636892,-10355
2022,3,3110365,1769208,1763724,5484
2022,3,3110364,1559806,1590175,-30369
2022,3,3110363,291051,337863,-46812
2022,3,3110362,857412,948146,-90734
2022,3,3110361,864053,887860,-23807
2022,3,3110360,1203524,1459157,-255633
2022,3,3110359,1018546,1030314,-11768
2022,3,3110358,976991,1045031,-68040
2022,3,3110357,1045178,1119810,-74632
2022,3,3110356,1155689,1130260,25429
2022,3,3110355,1256884,1283426,-26542
2022,3,3110354,91990,88610,3380
2022,3,3110353,641889,758674,-116785
2022,3,3110352,1695404,1576090,119314
2022,3,3110351,621261,820284,-199023
2022,3,3110350,530425,565640,-35215
2022,3,3110349,651349,573256,78093
2022,3,3110348,2190858,2214879,-24021
2022,3,3110346,716792,516916,199876
2022,3,3110345,693204,690280,2924
2022,3,3110344,336814,317940,18874
2022,3,3110343,889547,952985,-63438
2022,3,3110342,1023222,1008040,15182
2022,3,3110341,237999,398571,-160572
2022,3,3110340,357331,288850,68481
2022,3,3110337,483800,481718,2082
2022,3,3110336,340825,385249,-44424
2022,3,3110335,1305208,1358988,-53780
2022,3,3110334,2269036,1713726,555310
2022,3,3110333,659459,999757,-340298
2022,3,3110332,290038,208145,81893
2022,3,3110331,1148330,1206849,-58519
2022,3,3110330,864860,887581,-22721
2022,3,3110329,503112,342899,160213
2022,3,3110328,1052535,953822,98713
2022,3,3110327,963724,1018561,-54837
2022,3,3110326,462638,488323,-25685
2022,3,3110325,1035431,1022501,12930
2022,3,3110323,1492820,1511041,-18221
2022,3,3110322,760135,883847,-123712
2022,3,3110320,187633,199619,-11986
2022,3,3110319,1143351,1428781,-285430
2022,3,3110318,1202140,1030279,171861
2022,3,3110317,714022,564433,149589
2022,3,3110316,2970034,2923131,46903
2022,3,3110315,1602448,1464029,138419
2022,3,3110314,756369,752272,4097
2022,3,3110313,1424912,1185277,239635
2022,3,3110312,462148,459333,2815
2022,3,3110310,36242,44279,-8037
2022,3,3110309,360886,370924,-10038
2022,3,3110308,1061081,655078,406003
2022,3,3110307,691708,658366,33342
2022,3,3110306,168982,100570,68412
2022,3,3110305,1969556,1809468,160088
2022,3,3110304,1018304,802630,215674
2022,3,3110303,1326326,1320355,5971
2022,3,3110302,269375,306876,-37501
2022,3,3110301,1615811,1559151,56660
2022,3,3110300,2806297,2832363,-26066
2022,3,3110299,1859953,1921676,-61723
2022,3,3110298,338006,278324,59682
2022,3,3110297,2377364,2010034,367330
2022,3,3110296,965140,952851,12289
2022,3,3110295,923533,981680,-58147
2022,3,3110294,1512121,1598173,-86052
2022,3,3110293,1430329,1420684,9645
2022,3,3110292,314195,312148,2047
2022,3,3110291,2092902,2194855,-101953
2022,3,3110290,203724,194364,9360
2022,3,3110289,1406217,1374891,31326
2022,3,3110288,312232,318191,-5959
2022,3,3110287,225811,228249,-2438
2022,3,3110286,679421,626016,53405
2022,3,3110285,133970,151962,-17992
2022,3,3110284,87579,100323,-12744
2022,3,3110283,149022,151034,-2012
2022,3,3110282,39352,34139,5213
2022,3,3110281,74213,84589,-10376
2022,3,3110280,257437,240217,17220
2022,3,3110278,781008,989385,-208377
2022,3,3110277,969658,1290890,-321232
2022,3,3110276,46991,53598,-6607
2022,3,3110275,564116,484308,79808
2022,3,3110274,1211142,1259927,-48785
2022,3,3110273,837428,758640,78788
2022,3,3110272,1280832,1255791,25041
2022,3,3110271,48782,46341,2441
2022,3,3110270,365850,447296,-81446
2022,3,3110269,457825,459850,-2025
2022,3,3110268,557985,567000,-9015
2022,3,3110267,1308319,1479959,-171640
2022,3,3110266,1570695,1739791,-169096
2022,3,3110265,518969,476332,42637
2022,3,3110264,2948520,2924142,24378
2022,3,3110263,1357414,2066190,-708776
2022,3,3110262,1898644,1652365,246279
2022,3,3110261,1510786,1544476,-33690
2022,3,3110260,1523215,1266178,257037
2022,3,3110259,1597119,1565768,31351
2022,3,3110258,735947,925171,-189224
2022,3,3110257,1770773,2029534,-258761
2022,3,3110256,1667575,1667678,-103
2022,3,3110255,1974284,2158884,-184600
2022,3,3110254,3521219,3934327,-413108
2022,3,3110253,797356,894610,-97254
2022,3,3110252,1000529,781020,219509
2022,3,3110251,741497,672633,68864
2022,3,3110250,470566,503684,-33118
2022,3,3110249,2147386,2041780,105606
2022,3,3110248,575011,566500,8511
2022,3,3110247,2232520,2095193,137327
2022,3,3110246,1423135,1303806,119329
2022,3,3110245,547368,538911,8457
2022,3,3110244,852268,959713,-107445
2022,3,3110243,754636,1096508,-341872
2022,3,3110242,512819,856799,-343980
2022,3,3110241,1003175,1175761,-172586
2022,3,3110240,695548,674007,21541
2022,3,3110238,91782,120626,-28844
2022,3,3110237,966375,1038003,-71628
2022,3,3110236,1982803,2006277,-23474
2022,3,3110234,310865,366594,-55729
2022,3,3110233,1210516,1464072,-253556
2022,3,3110232,822770,823383,-613
2022,3,3110230,1052987,997061,55926
2022,3,3110229,1822312,1779274,43038
2022,3,3110228,1544224,1688669,-144445
2022,3,3110227,556963,596930,-39967
2022,3,3110226,2593736,2573613,20123
2022,3,3110225,288583,455452,-166869
2022,3,3110224,640197,559093,81104
2022,3,3110221,273342,207010,66332
2022,3,3110220,1178314,1040473,137841
2022,3,3110219,1610867,1620304,-9437
2022,3,3110218,1319714,1223850,95864
2022,3,3110217,620720,636355,-15635
2022,3,3110216,317931,329071,-11140
2022,3,3110215,735047,714147,20900
2022,3,3110214,1489881,1172182,317699
2022,3,3110213,530402,481671,48731
2022,3,3110212,1069362,849215,220147
2022,3,3110211,2220205,2299982,-79777
2022,3,3110210,2234298,2020393,213905
2022,3,3110209,329392,371516,-42124
2022,3,3110208,390613,361715,28898
2022,3,3110207,539592,558694,-19102
2022,3,3110206,1462601,1644257,-181656
2022,3,3110205,2161057,1865770,295287
2022,3,3110204,1359950,1390832,-30882
2022,3,3110203,465537,671972,-206435
2022,3,3110201,134806,140601,-5795
2022,3,3110200,430244,475190,-44946
2022,3,3110199,318676,458872,-140196
2022,3,3110197,284400,301701,-17301
2022,3,3110195,1546108,1455909,90199
2022,3,3110194,344881,588922,-244041
2022,3,3110193,834726,769277,65449
2022,3,3110191,1655401,1144863,510538
2022,3,3110190,1115548,1313910,-198362
2022,3,3110189,973081,1047073,-73992
2022,3,3110188,840688,766904,73784
2022,3,3110187,2579362,2737340,-157978
2022,3,3110186,150522,155057,-4535
2022,3,3110185,644433,541306,103127
2022,3,3110184,272768,231224,41544
2022,3,3110183,576039,473604,102435
2022,3,3110182,801452,815230,-13778
2022,3,3110181,1418766,1073809,344957
2022,3,3110180,242553,252925,-10372
2022,3,3110179,510025,488881,21144
2022,3,3110178,320623,304948,15675
2022,3,3110177,98800,115874,-17074
2022,3,3110176,1291204,1519250,-228046
2022,3,3110175,1134570,1296625,-162055
2022,3,3110174,840129,955464,-115335
2022,3,3110173,385921,419879,-33958
2022,3,3110172,924953,843992,80961
2022,3,3110171,336864,296965,39899
2022,3,3110170,2946578,2915947,30631
2022,3,3110169,618007,591729,26278
2022,3,3110168,459691,480410,-20719
2022,3,3110167,1735597,1805425,-69828
2022,3,3110166,1985592,1930469,55123
2022,3,3110165,715069,779664,-64595
2022,3,3110164,451569,445316,6253
2022,3,3110163,619471,712570,-93099
2022,3,3110162,487037,560330,-73293
2022,3,3110161,976182,1106139,-129957
2022,3,3110160,508287,750596,-242309
2022,3,3110159,3472753,3401170,71583
2022,3,3110158,2598728,2500080,98648
2022,3,3110157,1415326,1243663,171663
2022,3,3110156,1088547,1087984,563
2022,3,3110155,872103,807588,64515
2022,3,3110154,1824539,2047529,-222990
2022,3,3110153,294592,364749,-70157
2022,3,3110152,261142,292324,-31182
2022,3,3110151,1334458,1365549,-31091
2022,3,3110150,1837886,1951940,-114054
2022,3,3110149,235819,258832,-23013
2022,3,3110148,573212,459373,113839
2022,3,3110147,908007,1115023,-207016
2022,3,3110146,1688576,1684870,3706
2022,3,3110144,398928,363747,35181
2022,3,3110142,1958683,1678664,280019
2022,3,3110141,1799407,1664032,135375
2022,3,3110140,2242428,2007453,234975
2022,3,3110139,2132681,1993437,139244
2022,3,3110138,1294232,1319178,-24946
2022,3,3110137,1502012,1324688,177324
2022,3,3110136,1229845,1249492,-19647
2022,3,3110135,217191,221202,-4011
2022,3,3110134,1438036,1555954,-117918
2022,3,3110133,354308,545410,-191102
2022,3,3110132,501262,612906,-111644
2022,3,3110131,776493,818858,-42365
2022,3,3110130,477697,486474,-8777
2022,3,3110129,190961,280055,-89094
2022,3,3110128,1296017,1414861,-118844
2022,3,3110127,141592,145550,-3958
2022,3,3110126,380754,291938,88816
2022,3,3110125,974865,860461,114404
2022,3,3110124,254128,549392,-295264
2022,3,3110123,785097,817861,-32764
2022,3,3110122,289719,311197,-21478
2022,3,3110121,146503,132651,13852
2022,3,3110120,682178,474635,207543
2022,3,3110118,826013,591656,234357
2022,3,3110117,494016,558727,-64711
2022,3,3110116,622599,693274,-70675
2022,3,3110115,758357,1034083,-275726
2022,3,3110114,402902,410783,-7881
2022,3,3110113,160595,180193,-19598
2022,3,3110112,846976,923279,-76303
2022,3,3110110,1000587,1029350,-28763
2022,3,3110109,323001,306325,16676
2022,3,3110107,63723,126673,-62950
2022,3,3110105,864920,868673,-3753
2022,3,3110104,1253646,1171125,82521
2022,3,3110103,332034,279583,52451
2022,3,3110102,536319,626424,-90105
2022,3,3110099,280581,310054,-29473
2022,3,3110098,86941,83975,2966
2022,3,3110096,258500,239522,18978
2022,3,3110095,486656,475376,11280
2022,3,3110093,2527428,2534511,-7083
2022,3,3110092,726036,746080,-20044
2022,3,3110090,595771,653195,-57424
2022,3,3110089,507620,522165,-14545
2022,3,3110088,385743,408358,-22615
2022,3,3110087,274606,252705,21901
2022,3,3110085,1329965,1320542,9423
2022,3,3110084,917876,866540,51336
2022,3,3110083,92603,100279,-7676
2022,3,3110082,388194,302348,85846
2022,3,3110081,1799335,1806639,-7304
2022,3,3110080,1428250,1743401,-315151
2022,3,3110079,2114982,2306019,-191037
2022,3,3110078,114624,114135,489
2022,3,3110077,549862,459078,90784
2022,3,3110075,858072,841494,16578
2022,3,3110074,763999,745823,18176
2022,3,3110073,227258,98169,129089
2022,3,3110071,39110,39196,-86
2022,3,3110070,50046,58475,-8429
2022,3,3110069,2307919,2156041,151878
2022,3,3110068,1711656,1619215,92441
2022,3,3110067,2410296,2323683,86613
2022,3,3110066,1331423,1336360,-4937
2022,3,3110065,56571,62253,-5682
2022,3,3110064,1361953,1502974,-141021
2022,3,3110063,840535,907447,-66912
2022,3,3110062,819334,871212,-51878
2022,3,3110061,1260958,1361489,-100531
2022,3,3110060,611202,665047,-53845
2022,3,3110059,898301,838836,59465
2022,3,3110058,1523504,1497219,26285
2022,3,3110057,787721,838067,-50346
2022,3,3110056,1957431,2067020,-109589
2022,3,3110055,506131,524951,-18820
2022,3,3110054,960623,1004505,-43882
2022,3,3110053,1061457,1236807,-175350
2022,3,3110052,579479,565115,14364
2022,3,3110051,911490,836014,75476
2022,3,3110050,414370,402512,11858
2022,3,3110049,687604,603782,83822
2022,3,3110048,821941,816887,5054
2022,3,3110047,598269,621936,-23667
2022,3,3110045,701270,591463,109807
2022,3,3110043,737285,745072,-7787
2022,3,3110042,183182,163945,19237
2022,3,3110041,310764,253733,57031
2022,3,3110040,172911,166077,6834
2022,3,3110039,88190,86355,1835
2022,3,3110037,870104,955115,-85011
2022,3,3110036,377077,349697,27380
2022,3,3110035,1323092,1465744,-142652
2022,3,3110033,685461,721708,-36247
2022,3,3110031,61202,76274,-15072
2022,3,3110030,142789,146017,-3228
2022,3,3110029,3277640,3050933,226707
2022,3,3110028,2623938,2585245,38693
2022,3,3110027,385225,376964,8261
2022,3,3110025,241228,225737,15491
2022,3,3110024,323937,306317,17620
2022,3,3110023,374669,427992,-53323
2022,3,3110022,559847,559589,258
2022,3,3110021,1399295,1191770,207525
2022,3,3110020,1915828,1693528,222300
2022,3,3110018,468901,395900,73001
2022,3,3110017,459804,431974,27830
2022,3,3110016,35266,31064,4202
2022,3,3110014,55984,50024,5960
2022,3,3110012,616940,547750,69190
2022,3,3110010,171884,197159,-25275
2022,3,3110009,172025,178673,-6648
2022,3,3110008,1285556,1344603,-59047
2022,3,3110007,876340,939803,-63463
2022,3,3110006,6894,9637,-2743
2022,3,3110005,121114,137538,-16424
2022,3,3110004,545454,643178,-97724
2022,3,3110003,634516,714379,-79863
2022,3,3110002,577170,543648,33522
2022,3,3110001,152037,129831,22206
2022,2,3111089,831137,1015413,-184276
2022,2,3111088,320910,437599,-116689
2022,2,3111087,219530,328107,-108577
2022,2,3111086,380220,400025,-19805
2022,2,3111085,840202,981205,-141003
2022,2,3111084,192701,171013,21688
2022,2,3111083,971791,929544,42247
2022,2,3111082,140941,192677,-51736
2022,2,3111080,563666,481546,82120
2022,2,3111079,361052,391848,-30796
2022,2,3111078,4062309,3911604,150705
2022,2,3111077,3297767,3191270,106497
2022,2,3111076,437598,512812,-75214
2022,2,3111075,1500523,1426482,74041
2022,2,3111074,617550,674209,-56659
2022,2,3111073,3591131,3136297,454834
2022,2,3111072,2230206,2313663,-83457
2022,2,3111071,530411,427850,102561
2022,2,3111070,1504200,2107118,-602918
2022,2,3111069,2656436,2425334,231102
2022,2,3111068,251235,252169,-934
2022,2,3111067,2571669,2752550,-180881
2022,2,3111066,1235481,1162004,73477
2022,2,3111065,587982,734741,-146759
2022,2,3111064,525387,627199,-101812
2022,2,3111063,1404886,1493078,-88192
2022,2,3111062,899495,744122,155373
2022,2,3111061,3054434,2720904,333530
2022,2,3111060,3540886,3193519,347367
2022,2,3111059,3393472,3470637,-77165
2022,2,3111058,471160,579159,-107999
2022,2,3111057,931072,909358,21714
2022,2,3111056,347383,281445,65938
2022,2,3111055,27985,26031,1954
2022,2,3111054,199988,170702,29286
2022,2,3111053,1136170,1196894,-60724
2022,2,3111052,1260286,1004110,256176
2022,2,3111051,2893405,2982315,-88910
2022,2,3111049,1287310,1285276,2034
2022,2,3111047,270806,525585,-254779
2022,2,3111046,2058625,2388088,-329463
2022,2,3111045,273959,229787,44172
2022,2,3111044,1441632,1468647,-27015
2022,2,3111043,712179,692661,19518
2022,2,3111042,1905547,1746628,158919
2022,2,3111040,618512,620262,-1750
2022,2,3111039,990736,839889,150847
2022,2,3111038,444259,718417,-274158
2022,2,3111037,245904,247324,-1420
2022,2,3111036,354867,333745,21122
2022,2,3111035,823489,876665,-53176
2022,2,3111034,847409,736390,111019
2022,2,3111033,48506,113552,-65046
2022,2,3111032,375313,569720,-194407
2022,2,3111031,971361,635535,335826
2022,2,3111030,1413573,979849,433724
2022,2,3111029,186845,216626,-29781
2022,2,3111028,940076,640900,299176
2022,2,3111027,919793,1397421,-477628
2022,2,3111026,935778,1065072,-129294
2022,2,3111025,789347,691417,97930
2022,2,3111024,434512,426418,8094
2022,2,3111023,875867,691649,184218
2022,2,3111022,372741,496645,-123904
2022,2,3111021,2349518,2505755,-156237
2022,2,3111020,233585,128206,105379
2022,2,3111019,1480512,1514424,-33912
2022,2,3111017,190138,322286,-132148
2022,2,3111016,747031,835543,-88512
2022,2,3111015,2034909,2042824,-7915
2022,2,3111014,739036,547911,191125
2022,2,3111013,2457091,2297413,159678
2022,2,3111012,1034498,1469175,-434677
2022,2,3111011,36933,65689,-28756
2022,2,3111010,1865758,2077985,-212227
2022,2,3111009,241411,268489,-27078
2022,2,3111008,744972,677010,67962
2022,2,3111007,1239377,1192137,47240
2022,2,3111006,2336053,2190452,145601
2022,2,3111005,1434984,1285233,149751
2022,2,3111004,2309320,2209681,99639
2022,2,3111003,2075947,1996549,79398
2022,2,3111001,51006,60438,-9432
2022,2,3110999,151319,163952,-12633
2022,2,3110997,2012571,2719240,-706669
2022,2,3110996,744255,672094,72161
2022,2,3110995,592808,646310,-53502
2022,2,3110994,485580,572232,-86652
2022,2,3110992,1920712,1835340,85372
2022,2,3110989,690559,718574,-28015
2022,2,3110988,127337,197808,-70471
2022,2,3110984,942177,902170,40007
2022,2,3110983,459352,393125,66227
2022,2,3110982,357951,376811,-18860
2022,2,3110981,426501,443606,-17105
2022,2,3110980,538000,421176,116824
2022,2,3110979,328543,292513,36030
2022,2,3110976,742194,765647,-23453
2022,2,3110975,320980,264575,56405
2022,2,3110974,445764,513394,-67630
2022,2,3110973,1157676,1084333,73343
2022,2,3110972,353230,293674,59556
2022,2,3110971,801351,969310,-167959
2022,2,3110970,352513,426021,-73508
2022,2,3110969,798395,681293,117102
2022,2,3110968,299532,278264,21268
2022,2,3110967,724580,628285,96295
2022,2,3110966,1692375,1700619,-8244
2022,2,3110961,916220,1177170,-260950
2022,2,3110959,60604,125338,-64734
2022,2,3110958,624936,617438,7498
2022,2,3110957,910322,853636,56686
2022,2,3110956,447761,340122,107639
2022,2,3110955,2883664,2819578,64086
2022,2,3110954,461153,434935,26218
2022,2,3110953,440834,411726,29108
2022,2,3110952,219900,215442,4458
2022,2,3110951,598915,626391,-27476
2022,2,3110949,386687,326713,59974
2022,2,3110947,40565,54749,-14184
2022,2,3110945,33414,42989,-9575
2022,2,3110943,496395,516890,-20495
2022,2,3110942,1782038,1789144,-7106
2022,2,3110940,407419,352757,54662
2022,2,3110939,1988732,1884652,104080
2022,2,3110936,206232,182203,24029
2022,2,3110935,643296,427679,215617
2022,2,3110934,428974,409604,19370
2022,2,3110932,239519,247584,-8065
2022,2,3110931,24640,22677,1963
2022,2,3110930,591557,602811,-11254
2022,2,3110929,1546407,1072637,473770
2022,2,3110926,1073432,1087494,-14062
2022,2,3110925,617752,575302,42450
2022,2,3110924,444902,672817,-227915
2022,2,3110922,838749,822170,16579
2022,2,3110921,421154,318246,102908
2022,2,3110919,660942,697385,-36443
2022,2,3110918,1051521,1072752,-21231
2022,2,3110917,110443,108837,1606
2022,2,3110916,785595,634930,150665
2022,2,3110915,184061,216276,-32215
2022,2,3110913,859915,1098607,-238692
2022,2,3110912,171517,205723,-34206
2022,2,3110910,362975,331194,31781
2022,2,3110908,22882,101431,-78549
2022,2,3110907,887750,1004057,-116307
2022,2,3110906,559883,422469,137414
2022,2,3110905,418929,557087,-138158
2022,2,3110904,261658,247688,13970
2022,2,3110903,826270,1012425,-186155
2022,2,3110902,2371751,3043358,-671607
2022,2,3110901,1183901,1374578,-190677
2022,2,3110900,1917258,1446152,471106
2022,2,3110899,978066,780833,197233
2022,2,3110897,1506511,1824360,-317849
2022,2,3110896,201277,193471,7806
2022,2,3110895,3936707,3725475,211232
2022,2,3110893,86944,60863,26081
2022,2,3110892,4765615,4986225,-220610
2022,2,3110891,147016,313516,-166500
2022,2,3110890,851743,657910,193833
2022,2,3110889,493061,395420,97641
2022,2,3110888,726837,857600,-130763
2022,2,3110887,523087,513974,9113
2022,2,3110886,1137610,1036066,101544
2022,2,3110885,1461027,1539067,-78040
2022,2,3110884,774529,809898,-35369
2022,2,3110883,1159577,1382716,-223139
2022,2,3110882,1656311,1634977,21334
2022,2,3110881,4391647,3955180,436467
2022,2,3110880,493916,464566,29350
2022,2,3110879,296407,320465,-24058
2022,2,3110878,713230,556254,156976
2022,2,3110877,1352886,1189193,163693
2022,2,3110876,580655,642260,-61605
2022,2,3110875,173414,173384,30
2022,2,3110874,1965060,2160078,-195018
2022,2,3110873,661996,1040500,-378504
2022,2,3110872,799463,745212,54251
2022,2,3110871,740563,647712,92851
2022,2,3110869,4713491,3949190,764301
2022,2,3110868,731116,884196,-153080
2022,2,3110867,1315631,1249700,65931
2022,2,3110866,1272469,1052157,220312
2022,2,3110865,2216555,2169798,46757
2022,2,3110864,1782532,1753114,29418
2022,2,3110863,931871,1292230,-360359
2022,2,3110862,740511,750301,-9790
2022,2,3110861,2112716,1792913,319803
2022,2,3110860,486038,491903,-5865
2022,2,3110859,586431,376188,210243
2022,2,3110858,502012,376577,125435
2022,2,3110857,1110693,1198271,-87578
2022,2,3110856,888439,859834,28605
2022,2,3110855,1317326,1854533,-537207
2022,2,3110854,428616,312277,116339
2022,2,3110853,1770760,1596990,173770
2022,2,3110852,778394,622430,155964
2022,2,3110851,1186040,915901,270139
2022,2,3110850,2564820,2750526,-185706
2022,2,3110849,1867712,1476239,391473
2022,2,3110848,1448207,1390732,57475
2022,2,3110847,874741,845268,29473
2022,2,3110846,2819947,3062726,-242779
2022,2,3110845,388186,414955,-26769
2022,2,3110843,489008,640937,-151929
2022,2,3110842,165884,187733,-21849
2022,2,3110841,1421098,1271385,149713
2022,2,3110840,963766,865385,98381
2022,2,3110839,781231,799315,-18084
2022,2,3110838,152362,134739,17623
2022,2,3110837,1900732,1689107,211625
2022,2,3110836,1550973,1952889,-401916
2022,2,3110835,162976,156506,6470
2022,2,3110833,598244,473551,124693
2022,2,3110832,601311,575919,25392
2022,2,3110831,531073,472138,58935
2022,2,3110830,593594,883566,-289972
2022,2,3110829,744866,892981,-148115
2022,2,3110828,1880340,1984433,-104093
2022,2,3110827,569912,587769,-17857
2022,2,3110826,725238,1013192,-287954
2022,2,3110825,2071345,2192733,-121388
2022,2,3110824,262863,338884,-76021
2022,2,3110823,694445,677378,17067
2022,2,3110822,568546,690988,-122442
2022,2,3110821,1399833,1310473,89360
2022,2,3110820,872929,929581,-56652
2022,2,3110819,836282,948263,-111981
2022,2,3110818,154028,148093,5935
2022,2,3110817,327969,311068,16901
2022,2,3110816,718193,677900,40293
2022,2,3110815,1545950,1575869,-29919
2022,2,3110814,1388848,1359154,29694
2022,2,3110813,1310206,1122693,187513
2022,2,3110812,605664,680063,-74399
2022,2,3110811,436812,409211,27601
2022,2,3110810,1644995,1628557,16438
2022,2,3110809,415346,479900,-64554
2022,2,3110807,488405,466433,21972
2022,2,3110805,316542,305239,11303
2022,2,3110804,865956,868710,-2754
2022,2,3110803,1342814,1358547,-15733
2022,2,3110802,590315,495793,94522
2022,2,3110800,156306,159387,-3081
2022,2,3110799,171676,240208,-68532
2022,2,3110798,133104,133878,-774
2022,2,3110796,84563,99251,-14688
2022,2,3110795,1111326,1082306,29020
2022,2,3110794,849832,658917,190915
2022,2,3110792,2140773,2258049,-117276
2022,2,3110791,115876,81268,34608
2022,2,3110790,728247,1606882,-878635
2022,2,3110789,567812,488428,79384
2022,2,3110788,83972,78901,5071
2022,2,3110787,1287967,1835200,-547233
2022,2,3110786,422344,422677,-333
2022,2,3110785,1088925,1027026,61899
2022,2,3110784,195942,190740,5202
2022,2,3110783,232082,541118,-309036
2022,2,3110782,184598,386951,-202353
2022,2,3110781,1340522,1242713,97809
2022,2,3110780,334757,350140,-15383
2022,2,3110778,1227777,1528603,-300826
2022,2,3110777,266202,291556,-25354
2022,2,3110776,805026,883622,-78596
2022,2,3110775,309395,191133,118262
2022,2,3110774,478308,503904,-25596
2022,2,3110772,321287,286531,34756
2022,2,3110771,423149,345782,77367
2022,2,3110770,649556,900775,-251219
2022,2,3110769,517724,442021,75703
2022,2,3110768,222173,181633,40540
2022,2,3110767,253570,255786,-2216
2022,2,3110766,1230753,1140260,90493
2022,2,3110765,325251,271430,53821
2022,2,3110762,1837143,1699042,138101
2022,2,3110760,772011,710330,61681
2022,2,3110758,358095,344516,13579
2022,2,3110757,205887,210667,-4780
2022,2,3110756,215909,222031,-6122
2022,2,3110755,266436,318625,-52189
2022,2,3110754,1509782,1059355,450427
2022,2,3110753,1004669,1094813,-90144
2022,2,3110752,781327,1077134,-295807
2022,2,3110751,1009017,1116096,-107079
2022,2,3110750,876889,906587,-29698
2022,2,3110749,608378,597536,10842
2022,2,3110748,374387,462003,-87616
2022,2,3110747,156529,154369,2160
2022,2,3110746,210408,359041,-148633
2022,2,3110745,417513,733330,-315817
2022,2,3110744,1614892,1854416,-239524
2022,2,3110743,890975,823786,67189
2022,2,3110742,70863,65157,5706
2022,2,3110741,626260,540373,85887
2022,2,3110740,1555593,1296440,259153
2022,2,3110739,29944,28895,1049
2022,2,3110738,888302,771465,116837
2022,2,3110737,1570345,1337568,232777
2022,2,3110736,813336,677264,136072
2022,2,3110735,1095627,1094599,1028
2022,2,3110734,22825,43385,-20560
2022,2,3110733,238521,270281,-31760
2022,2,3110732,359003,427532,-68529
2022,2,3110731,445931,313607,132324
2022,2,3110730,540242,460037,80205
2022,2,3110729,607517,574509,33008
2022,2,3110728,172975,230742,-57767
2022,2,3110727,379026,245352,133674
2022,2,3110726,247945,369750,-121805
2022,2,3110725,215475,273655,-58180
2022,2,3110724,618327,662090,-43763
2022,2,3110723,304226,292398,11828
2022,2,3110722,356030,314034,41996
2022,2,3110721,1125484,876707,248777
2022,2,3110720,1053952,1082898,-28946
2022,2,3110719,309623,255115,54508
2022,2,3110718,969034,892868,76166
2022,2,3110717,3006486,3550160,-543674
2022,2,3110716,410540,343715,66825
2022,2,3110715,295090,334265,-39175
2022,2,3110714,1542419,1444437,97982
2022,2,3110713,2826905,2788708,38197
2022,2,3110712,2086279,1795038,291241
2022,2,3110711,1294880,1179805,115075
2022,2,3110710,2357426,2939258,-581832
2022,2,3110709,1290144,1128027,162117
2022,2,3110708,353392,375642,-22250
2022,2,3110707,1127802,1251013,-123211
2022,2,3110706,294212,245190,49022
2022,2,3110703,620683,625601,-4918
2022,2,3110702,1085231,759083,326148
2022,2,3110701,677330,382127,295203
2022,2,3110700,963625,930295,33330
2022,2,3110699,504396,518297,-13901
2022,2,3110698,713574,680499,33075
2022,2,3110697,551799,515654,36145
2022,2,3110696,594075,744183,-150108
2022,2,3110695,1610900,1899710,-288810
2022,2,3110694,1854474,2128834,-274360
2022,2,3110693,102904,94945,7959
2022,2,3110692,1014213,807614,206599
2022,2,3110691,715768,970791,-255023
2022,2,3110690,1923619,1953022,-29403
2022,2,3110689,662904,711756,-48852
2022,2,3110688,970411,844819,125592
2022,2,3110687,61932,172439,-110507
2022,2,3110686,759932,926657,-166725
2022,2,3110684,58476,337544,-279068
2022,2,3110683,277253,284506,-7253
2022,2,3110681,29670,36249,-6579
2022,2,3110680,224010,327127,-103117
2022,2,3110679,249036,240012,9024
2022,2,3110678,170586,214232,-43646
2022,2,3110677,183859,250098,-66239
2022,2,3110676,452165,518051,-65886
2022,2,3110675,1681499,1742016,-60517
2022,2,3110673,663905,930397,-266492
2022,2,3110672,674317,624990,49327
2022,2,3110671,2102388,2149459,-47071
2022,2,3110670,1556836,1350228,206608
2022,2,3110668,1763670,1509649,254021
2022,2,3110666,203460,289945,-86485
2022,2,3110665,1133828,1417915,-284087
2022,2,3110664,238829,209006,29823
2022,2,3110663,257487,322606,-65119
2022,2,3110662,2535842,2313137,222705
2022,2,3110661,281993,346391,-64398
2022,2,3110660,710602,679222,31380
2022,2,3110659,4772045,4924316,-152271
2022,2,3110658,888647,1105434,-216787
2022,2,3110657,714814,762061,-47247
2022,2,3110656,6044827,5572994,471833
2022,2,3110655,389554,363579,25975
2022,2,3110654,2390334,2959381,-569047
2022,2,3110653,970114,739766,230348
2022,2,3110652,312153,288850,23303
2022,2,3110651,544545,1193052,-648507
2022,2,3110650,80790,239385,-158595
2022,2,3110649,999740,1063466,-63726
2022,2,3110647,2616813,2380799,236014
2022,2,3110646,1764249,2118614,-354365
2022,2,3110645,1398176,1642360,-244184
2022,2,3110644,93378,98938,-5560
2022,2,3110643,638693,708114,-69421
2022,2,3110641,242290,514965,-272675
2022,2,3110640,601435,518503,82932
2022,2,3110639,417918,686687,-268769
2022,2,3110638,2222969,2047435,175534
2022,2,3110637,197996,199126,-1130
2022,2,3110636,635152,529272,105880
2022,2,3110635,272223,399313,-127090
2022,2,3110634,2071195,2134144,-62949
2022,2,3110633,55748,112020,-56272
2022,2,3110632,686000,489025,196975
2022,2,3110631,622572,656539,-33967
2022,2,3110630,1785234,2104407,-319173
2022,2,3110629,157835,133425,24410
2022,2,3110628,267378,259973,7405
2022,2,3110627,1355521,1124366,231155
2022,2,3110626,1477082,1283129,193953
2022,2,3110625,626564,813577,-187013
2022,2,3110624,469052,520935,-51883
2022,2,3110622,485286,468913,16373
2022,2,3110621,272288,333161,-60873
2022,2,3110620,2192694,2230871,-38177
2022,2,3110619,329508,324439,5069
2022,2,3110618,1553678,1532184,21494
2022,2,3110617,514443,550078,-35635
2022,2,3110616,240829,168184,72645
2022,2,3110615,214763,266435,-51672
2022,2,3110614,520281,867360,-347079
2022,2,3110613,235622,209252,26370
2022,2,3110612,2090632,2655286,-564654
2022,2,3110611,1150846,1065273,85573
2022,2,3110609,979865,1029402,-49537
2022,2,3110608,1592395,1520463,71932
2022,2,3110607,157584,148742,8842
2022,2,3110606,1433318,1603082,-169764
2022,2,3110605,45722,142167,-96445
2022,2,3110604,1126231,1233224,-106993
2022,2,3110603,87511,81703,5808
2022,2,3110602,190044,210447,-20403
2022,2,3110601,1400803,1423153,-22350
2022,2,3110600,561178,592562,-31384
2022,2,3110599,1096659,940080,156579
2022,2,3110598,549782,481028,68754
2022,2,3110597,1174712,984354,190358
2022,2,3110596,632556,559728,72828
2022,2,3110595,587366,950513,-363147
2022,2,3110594,388785,450316,-61531
2022,2,3110593,1094750,1141193,-46443
2022,2,3110592,254006,222494,31512
2022,2,3110591,1518109,1465643,52466
2022,2,3110590,1627584,1284845,342739
2022,2,3110589,113929,226217,-112288
2022,2,3110588,1056743,1259767,-203024
2022,2,3110587,854523,719012,135511
2022,2,3110586,1774788,1406097,368691
2022,2,3110585,136274,245822,-109548
2022,2,3110584,106215,131553,-25338
2022,2,3110583,385526,362275,23251
2022,2,3110582,509836,672129,-162293
2022,2,3110580,758290,603115,155175
2022,2,3110579,319788,387503,-67715
2022,2,3110578,1396654,1298350,98304
2022,2,3110577,629158,617931,11227
2022,2,3110576,1216730,1159685,57045
2022,2,3110575,1116201,920724,195477
2022,2,3110574,52859,76043,-23184
2022,2,3110573,109092,100876,8216
2022,2,3110572,1867004,1709682,157322
2022,2,3110571,507927,577433,-69506
2022,2,3110570,213355,175157,38198
2022,2,3110569,976741,904754,71987
2022,2,3110568,299305,277455,21850
2022,2,3110567,272243,258086,14157
2022,2,3110566,1513826,1552205,-38379
2022,2,3110565,436307,334184,102123
2022,2,3110564,800590,596065,204525
2022,2,3110563,196574,213650,-17076
2022,2,3110562,1148487,1196781,-48294
2022,2,3110561,822730,802019,20711
2022,2,3110560,1090122,957673,132449
2022,2,3110559,969033,757662,211371
2022,2,3110558,2513508,2337293,176215
2022,2,3110557,891048,993594,-102546
2022,2,3110555,217010,197926,19084
2022,2,3110554,891234,1170203,-278969
2022,2,3110553,822910,639920,182990
2022,2,3110552,764147,927570,-163423
2022,2,3110551,1435434,1377779,57655
2022,2,3110550,1716437,1743476,-27039
2022,2,3110549,1231891,1278392,-46501
2022,2,3110548,1136253,1095797,40456
2022,2,3110547,852187,768553,83634
2022,2,3110546,765802,718905,46897
2022,2,3110545,531952,581060,-49108
2022,2,3110544,5182306,4753632,428674
2022,2,3110543,91900,101504,-9604
2022,2,3110542,1528303,1496653,31650
2022,2,3110541,1259218,1539776,-280558
2022,2,3110540,568400,673097,-104697
2022,2,3110539,285525,266450,19075
2022,2,3110538,392984,420739,-27755
2022,2,3110537,449299,434428,14871
2022,2,3110536,106859,117891,-11032
2022,2,3110535,1127136,1041262,85874
2022,2,3110534,631660,537663,93997
2022,2,3110533,4571052,4560562,10490
2022,2,3110532,1089227,888648,200579
2022,2,3110529,1112873,1131592,-18719
2022,2,3110528,940711,774131,166580
2022,2,3110527,564677,433244,131433
2022,2,3110526,144308,127584,16724
2022,2,3110525,332693,379216,-46523
2022,2,3110524,142893,119956,22937
2022,2,3110523,107229,101674,5555
2022,2,3110522,221332,363002,-141670
2022,2,3110521,670848,640619,30229
2022,2,3110520,599549,582632,16917
2022,2,3110519,1150231,1006239,143992
2022,2,3110517,179624,245534,-65910
2022,2,3110515,370577,289045,81532
2022,2,3110514,746995,598371,148624
2022,2,3110513,359117,363015,-3898
2022,2,3110512,528931,637729,-108798
2022,2,3110511,912351,815338,97013
2022,2,3110510,969928,867943,101985
2022,2,3110509,919274,893908,25366
2022,2,3110508,493075,625262,-132187
2022,2,3110507,1614901,1727402,-112501
2022,2,3110506,270565,178878,91687
2022,2,3110505,66275,55810,10465
2022,2,3110503,2051676,1565491,486185
2022,2,3110502,1634737,1501334,133403
2022,2,3110501,257991,273582,-15591
2022,2,3110500,83490,221333,-137843
2022,2,3110499,2457410,2118293,339117
2022,2,3110498,1841299,1899957,-58658
2022,2,3110496,997342,816996,180346
2022,2,3110495,1257388,1539333,-281945
2022,2,3110493,419433,504600,-85167
2022,2,3110491,74731,108375,-33644
2022,2,3110490,581945,735418,-153473
2022,2,3110489,543770,403323,140447
2022,2,3110488,484085,464952,19133
2022,2,3110487,118521,114959,3562
2022,2,3110486,605539,446817,158722
2022,2,3110485,549531,696253,-146722
2022,2,3110484,1681850,1893571,-211721
2022,2,3110483,682117,626904,55213
2022,2,3110482,306508,438618,-132110
2022,2,3110481,2381277,1872733,508544
2022,2,3110480,398303,596832,-198529
2022,2,3110479,1169849,1072025,97824
2022,2,3110478,436641,696348,-259707
2022,2,3110477,357608,502963,-145355
2022,2,3110476,137318,152373,-15055
2022,2,3110475,693673,616101,77572
2022,2,3110474,966974,845720,121254
2022,2,3110473,1805433,1680595,124838
2022,2,3110472,1172253,1184050,-11797
2022,2,3110471,1497994,1694441,-196447
2022,2,3110470,622040,647190,-25150
2022,2,3110469,1719972,1930120,-210148
2022,2,3110468,3436573,2997455,439118
2022,2,3110467,775772,860633,-84861
2022,2,3110466,1022825,1123419,-100594
2022,2,3110465,1606554,1538793,67761
2022,2,3110464,514370,555792,-41422
2022,2,3110463,583556,471457,112099
2022,2,3110462,974865,1258067,-283202
2022,2,3110461,239085,369732,-130647
2022,2,3110460,1698316,1507104,191212
2022,2,3110459,948508,1152450,-203942
2022,2,3110458,965518,1566526,-601008
2022,2,3110457,788183,729018,59165
2022,2,3110456,1610092,1664067,-53975
2022,2,3110455,1584899,1461814,123085
2022,2,3110454,1328664,1050045,278619
2022,2,3110453,1864137,1571749,292388
2022,2,3110452,889518,910026,-20508
2022,2,3110451,1359505,1325137,34368
2022,2,3110450,1793938,2008319,-214381
2022,2,3110449,924144,965393,-41249
2022,2,3110448,535008,871546,-336538
2022,2,3110447,519344,393694,125650
2022,2,3110446,319631,409461,-89830
2022,2,3110444,150980,140370,10610
2022,2,3110443,91178,127007,-35829
2022,2,3110442,171691,167931,3760
2022,2,3110441,664242,1219298,-555056
2022,2,3110440,365543,964727,-599184
2022,2,3110439,1152520,776790,375730
2022,2,3110438,1560064,1593758,-33694
2022,2,3110437,1517599,1497301,20298
2022,2,3110436,528399,408095,120304
2022,2,3110435,106536,101095,5441
2022,2,3110434,482683,491870,-9187
2022,2,3110433,1391797,1441892,-50095
2022,2,3110432,403215,452830,-49615
2022,2,3110431,481078,514147,-33069
2022,2,3110429,2099211,1955480,143731
2022,2,3110428,4049493,3659470,390023
2022,2,3110427,113859,164114,-50255
2022,2,3110426,1763345,1554210,209135
2022,2,3110425,659497,1199222,-539725
2022,2,3110424,2583444,2288999,294445
2022,2,3110423,316542,282241,34301
2022,2,3110422,913501,803014,110487
2022,2,3110421,372250,506499,-134249
2022,2,3110420,590141,678850,-88709
2022,2,3110419,869662,1199952,-330290
2022,2,3110418,776354,789214,-12860
2022,2,3110417,458627,404384,54243
2022,2,3110416,938910,771830,167080
2022,2,3110415,2027181,2007571,19610
2022,2,3110413,111288,137611,-26323
2022,2,3110412,172111,126385,45726
2022,2,3110411,686284,481115,205169
2022,2,3110410,800701,705827,94874
2022,2,3110409,712154,804223,-92069
2022,2,3110408,408926,389894,19032
2022,2,3110407,943161,970424,-27263
2022,2,3110406,202567,268613,-66046
2022,2,3110405,1463636,1981931,-518295
2022,2,3110404,3385640,3649027,-263387
2022,2,3110403,1669506,1597903,71603
2022,2,3110402,719539,865279,-145740
2022,2,3110401,173682,202834,-29152
2022,2,3110400,1287865,1370587,-82722
2022,2,3110399,1868770,2018614,-149844
2022,2,3110398,918454,826866,91588
2022,2,3110397,1764165,1830812,-66647
2022,2,3110396,1026713,1002996,23717
2022,2,3110395,295969,278341,17628
2022,2,3110394,1072016,1089896,-17880
2022,2,3110393,71189,58700,12489
2022,2,3110392,150932,132579,18353
2022,2,3110391,544022,570362,-26340
2022,2,3110390,543101,1063333,-520232
2022,2,3110389,382517,407105,-24588
2022,2,3110388,679011,656995,22016
2022,2,3110387,1724375,1418415,305960
2022,2,3110383,114240,349480,-235240
2022,2,3110382,633934,517308,116626
2022,2,3110381,422801,353654,69147
2022,2,3110380,692066,741077,-49011
2022,2,3110379,158956,189019,-30063
2022,2,3110378,828278,818217,10061
2022,2,3110377,768717,706648,62069
2022,2,3110376,3109472,3913049,-803577
2022,2,3110375,610797,507139,103658
2022,2,3110374,2367105,2525112,-158007
2022,2,3110373,1259502,1183310,76192
2022,2,3110372,1732901,1789428,-56527
2022,2,3110371,697187,859311,-162124
2022,2,3110370,1303270,1974101,-670831
2022,2,3110369,1127198,1463417,-336219
2022,2,3110368,2921828,2327013,594815
2022,2,3110367,1459541,1343628,115913
2022,2,3110366,621851,724442,-102591
2022,2,3110365,1755445,1766420,-10975
2022,2,3110364,1634770,1857355,-222585
2022,2,3110363,296289,418656,-122367
2022,2,3110362,840394,1083973,-243579
2022,2,3110361,931280,850602,80678
2022,2,3110360,1291804,1750900,-459096
2022,2,3110359,1019028,1183300,-164272
2022,2,3110358,1006406,1237861,-231455
2022,2,3110357,1066906,1069472,-2566
2022,2,3110356,1074859,1014625,60234
2022,2,3110355,1342034,1203165,138869
2022,2,3110354,84020,100512,-16492
2022,2,3110353,806727,739846,66881
2022,2,3110352,1712558,1467713,244845
2022,2,3110351,636785,793259,-156474
2022,2,3110350,530610,701193,-170583
2022,2,3110349,678333,505724,172609
2022,2,3110348,2123446,1831805,291641
2022,2,3110346,647981,517256,130725
2022,2,3110345,709289,712193,-2904
2022,2,3110344,374391,319774,54617
2022,2,3110343,902247,1010148,-107901
2022,2,3110342,1029568,1022811,6757
2022,2,3110341,246490,376090,-129600
2022,2,3110340,330843,304098,26745
2022,2,3110337,493168,487976,5192
2022,2,3110336,348189,675111,-326922
2022,2,3110335,1328851,1205030,123821
2022,2,3110334,1997853,1528492,469361
2022,2,3110333,655716,984579,-328863
2022,2,3110332,283434,191586,91848
2022,2,3110331,1239690,1265897,-26207
2022,2,3110330,910665,778373,132292
2022,2,3110329,492077,331259,160818
2022,2,3110328,1073058,789338,283720
2022,2,3110327,962011,1151264,-189253
2022,2,3110326,461489,365264,96225
2022,2,3110325,1076470,773210,303260
2022,2,3110323,1615081,1386815,228266
2022,2,3110322,775383,943657,-168274
2022,2,3110320,193923,218745,-24822
2022,2,3110319,1146000,1277765,-131765
2022,2,3110318,1369324,1060343,308981
2022,2,3110317,705701,532369,173332
2022,2,3110316,3096574,3195741,-99167
2022,2,3110315,1611645,1444712,166933
2022,2,3110314,761819,750002,11817
2022,2,3110313,1611308,1247651,363657
2022,2,3110312,608149,534140,74009
2022,2,3110310,33946,122750,-88804
2022,2,3110309,371218,424729,-53511
2022,2,3110308,1041923,703494,338429
2022,2,3110307,714514,775298,-60784
2022,2,3110306,168749,129636,39113
2022,2,3110305,2035453,1929982,105471
2022,2,3110304,1015252,919974,95278
2022,2,3110303,1453511,1573708,-120197
2022,2,3110302,257678,588385,-330707
2022,2,3110301,1564850,1481222,83628
2022,2,3110300,3073358,3247518,-174160
2022,2,3110299,1880337,1928738,-48401
2022,2,3110298,334438,272858,61580
2022,2,3110297,2183008,2118558,64450
2022,2,3110296,986572,813945,172627
2022,2,3110295,940813,1124913,-184100
2022,2,3110294,1582890,1546034,36856
2022,2,3110293,1480027,1442694,37333
2022,2,3110292,322196,282896,39300
2022,2,3110291,2178889,2200616,-21727
2022,2,3110290,209742,185467,24275
2022,2,3110289,1473594,1304465,169129
2022,2,3110288,327674,310765,16909
2022,2,3110287,240131,255106,-14975
2022,2,3110286,712866,584373,128493
2022,2,3110285,139109,216346,-77237
2022,2,3110284,97846,99085,-1239
2022,2,3110283,162205,159040,3165
2022,2,3110282,41371,33938,7433
2022,2,3110281,80121,75543,4578
2022,2,3110280,280180,193838,86342
2022,2,3110278,867184,1347983,-480799
2022,2,3110277,1240315,1367895,-127580
2022,2,3110276,48728,53063,-4335
2022,2,3110275,464534,424203,40331
2022,2,3110274,1290060,1381879,-91819
2022,2,3110273,776268,652385,123883
2022,2,3110272,1279046,1387875,-108829
2022,2,3110271,49119,44545,4574
2022,2,3110270,448837,428001,20836
2022,2,3110269,469967,485298,-15331
2022,2,3110268,527427,681333,-153906
2022,2,3110267,1400229,1608566,-208337
2022,2,3110266,1644716,1637615,7101
2022,2,3110265,494765,418398,76367
2022,2,3110264,3036991,2621590,415401
2022,2,3110263,1349689,2248500,-898811
2022,2,3110262,1869879,1417552,452327
2022,2,3110261,1508020,1516852,-8832
2022,2,3110260,1540585,1087259,453326
2022,2,3110259,1498025,1427636,70389
2022,2,3110258,655545,1144642,-489097
2022,2,3110257,1837508,2046183,-208675
2022,2,3110256,1649692,1524612,125080
2022,2,3110255,2051886,2703004,-651118
2022,2,3110254,3598471,3768770,-170299
2022,2,3110253,784118,952867,-168749
2022,2,3110252,865353,702671,162682
2022,2,3110251,756523,834119,-77596
2022,2,3110250,482127,676946,-194819
2022,2,3110249,2147041,1641014,506027
2022,2,3110248,584881,529354,55527
2022,2,3110247,2221751,1838251,383500
2022,2,3110246,1421144,1009804,411340
2022,2,3110245,519295,527565,-8270
2022,2,3110244,897272,941267,-43995
2022,2,3110243,995600,1347264,-351664
2022,2,3110242,758425,833077,-74652
2022,2,3110241,1144677,1235909,-91232
2022,2,3110240,706854,601763,105091
2022,2,3110238,92634,173657,-81023
2022,2,3110237,1019981,1202482,-182501
2022,2,3110236,2006627,1968861,37766
2022,2,3110234,324122,376986,-52864
2022,2,3110233,1209819,1630652,-420833
2022,2,3110232,865107,702800,162307
2022,2,3110230,1029723,872936,156787
2022,2,3110229,1832050,1572470,259580
2022,2,3110228,1590439,1737729,-147290
2022,2,3110227,597491,523285,74206
2022,2,3110226,2610360,2904728,-294368
2022,2,3110225,253750,610276,-356526
2022,2,3110224,601349,495248,106101
2022,2,3110221,263156,378244,-115088
2022,2,3110220,1245187,1124256,120931
2022,2,3110219,1714629,1582165,132464
2022,2,3110218,1318569,1072114,246455
2022,2,3110217,651972,612777,39195
2022,2,3110216,346717,397012,-50295
2022,2,3110215,758866,805074,-46208
2022,2,3110214,1672642,1164278,508364
2022,2,3110213,578923,492441,86482
2022,2,3110212,1109208,843512,265696
2022,2,3110211,2537592,2455027,82565
2022,2,3110210,2404780,2243196,161584
2022,2,3110209,321524,395898,-74374
2022,2,3110208,386438,372585,13853
2022,2,3110207,594689,544189,50500
2022,2,3110206,1540698,1633916,-93218
2022,2,3110205,2204803,1854285,350518
2022,2,3110204,1445184,1204475,240709
2022,2,3110203,628526,649689,-21163
2022,2,3110201,142532,113061,29471
2022,2,3110200,440932,503697,-62765
2022,2,3110199,417005,488870,-71865
2022,2,3110197,296677,238660,58017
2022,2,3110195,1496186,1503333,-7147
2022,2,3110194,447736,623862,-176126
2022,2,3110193,833562,791044,42518
2022,2,3110191,1508679,1245602,263077
2022,2,3110190,1415601,1340577,75024
2022,2,3110189,932253,864686,67567
2022,2,3110188,961409,806360,155049
2022,2,3110187,2843686,2996964,-153278
2022,2,3110186,154079,208468,-54389
2022,2,3110185,726883,484297,242586
2022,2,3110184,288344,219459,68885
2022,2,3110183,620785,491013,129772
2022,2,3110182,851319,752396,98923
2022,2,3110181,1386503,1175202,211301
2022,2,3110180,247010,261813,-14803
2022,2,3110179,542984,460515,82469
2022,2,3110178,339385,308763,30622
2022,2,3110177,90207,167807,-77600
2022,2,3110176,1413866,1485575,-71709
2022,2,3110175,1200157,1596176,-396019
2022,2,3110174,874561,858661,15900
2022,2,3110173,411352,463266,-51914
2022,2,3110172,798926,930136,-131210
2022,2,3110171,348950,479124,-130174
2022,2,3110170,3055354,2674878,380476
2022,2,3110169,657075,596017,61058
2022,2,3110168,492138,916620,-424482
2022,2,3110167,1758437,1547191,211246
2022,2,3110166,2155444,2015768,139676
2022,2,3110165,746841,1060397,-313556
2022,2,3110164,505112,541695,-36583
2022,2,3110163,696592,605066,91526
2022,2,3110162,520308,581422,-61114
2022,2,3110161,982048,1479571,-497523
2022,2,3110160,535087,678790,-143703
2022,2,3110159,3357589,3602374,-244785
2022,2,3110158,2594629,2099345,495284
2022,2,3110157,1407136,1136560,270576
2022,2,3110156,1151941,1201070,-49129
2022,2,3110155,980090,874970,105120
2022,2,3110154,2117625,2004035,113590
2022,2,3110153,297003,536459,-239456
2022,2,3110152,260441,305823,-45382
2022,2,3110151,1293523,1377998,-84475
2022,2,3110150,1848012,1733745,114267
2022,2,3110149,246919,284085,-37166
2022,2,3110148,632963,450093,182870
2022,2,3110147,946352,1541587,-595235
2022,2,3110146,1666586,1564337,102249
2022,2,3110144,404297,390394,13903
2022,2,3110142,1993949,1809918,184031
2022,2,3110141,1970820,1521034,449786
2022,2,3110140,2216102,2065808,150294
2022,2,3110139,2141986,2009068,132918
2022,2,3110138,1303581,1260402,43179
2022,2,3110137,1468893,1346623,122270
2022,2,3110136,1284699,1056422,228277
2022,2,3110135,227259,315186,-87927
2022,2,3110134,1488632,1795416,-306784
2022,2,3110133,371913,493587,-121674
2022,2,3110132,555857,692218,-136361
2022,2,3110131,756083,976976,-220893
2022,2,3110130,485224,433159,52065
2022,2,3110129,186356,272201,-85845
2022,2,3110128,1354214,1759448,-405234
2022,2,3110127,152448,143185,9263
2022,2,3110126,389273,207626,181647
2022,2,3110125,1044934,860807,184127
2022,2,3110124,362952,531105,-168153
2022,2,3110123,806727,814572,-7845
2022,2,3110122,310670,320162,-9492
2022,2,3110121,166309,189558,-23249
2022,2,3110120,511957,733437,-221480
2022,2,3110118,652901,639299,13602
2022,2,3110117,483636,679613,-195977
2022,2,3110116,656014,760725,-104711
2022,2,3110115,764127,881293,-117166
2022,2,3110114,436376,362353,74023
2022,2,3110113,174661,172945,1716
2022,2,3110112,893930,832967,60963
2022,2,3110110,1018634,975220,43414
2022,2,3110109,316311,374183,-57872
2022,2,3110107,67051,169124,-102073
2022,2,3110105,911665,927122,-15457
2022,2,3110104,1261816,1093270,168546
2022,2,3110103,243264,310900,-67636
2022,2,3110102,615301,548783,66518
2022,2,3110099,345804,297611,48193
2022,2,3110098,90469,92252,-1783
2022,2,3110096,263208,267710,-4502
2022,2,3110095,505322,555296,-49974
2022,2,3110093,2557210,2573671,-16461
2022,2,3110092,672368,971919,-299551
2022,2,3110090,657679,613377,44302
2022,2,3110089,522949,533254,-10305
2022,2,3110088,403105,391112,11993
2022,2,3110087,284486,250469,34017
2022,2,3110085,1356533,1316777,39756
2022,2,3110084,965725,935390,30335
2022,2,3110083,96737,122055,-25318
2022,2,3110082,374960,339467,35493
2022,2,3110081,1940832,1738825,202007
2022,2,3110080,1491485,2005427,-513942
2022,2,3110079,2144714,2444187,-299473
2022,2,3110078,117853,108319,9534
2022,2,3110077,541269,446650,94619
2022,2,3110075,879191,888535,-9344
2022,2,3110074,820229,774853,45376
2022,2,3110073,130985,125604,5381
2022,2,3110071,53271,59860,-6589
2022,2,3110070,65743,67187,-1444
2022,2,3110069,2649891,2214492,435399
2022,2,3110068,1718729,1708649,10080
2022,2,3110067,2478664,2127608,351056
2022,2,3110066,1364339,1415615,-51276
2022,2,3110065,59953,85826,-25873
2022,2,3110064,1527892,1440705,87187
2022,2,3110063,929316,917776,11540
2022,2,3110062,887935,1067183,-179248
2022,2,3110061,1272735,1438934,-166199
2022,2,3110060,612103,1023206,-411103
2022,2,3110059,969056,563308,405748
2022,2,3110058,1460928,1454789,6139
2022,2,3110057,842719,861944,-19225
2022,2,3110056,1989340,2103361,-114021
2022,2,3110055,538969,525067,13902
2022,2,3110054,980926,946580,34346
2022,2,3110053,1105407,1209732,-104325
2022,2,3110052,592403,662854,-70451
2022,2,3110051,947934,808601,139333
2022,2,3110050,402512,404737,-2225
2022,2,3110049,722142,732440,-10298
2022,2,3110048,850656,832225,18431
2022,2,3110047,605887,626849,-20962
2022,2,3110045,673529,611164,62365
2022,2,3110043,832270,780546,51724
2022,2,3110042,196077,180082,15995
2022,2,3110041,344233,283519,60714
2022,2,3110040,185333,160773,24560
2022,2,3110039,97249,81785,15464
2022,2,3110037,896186,833652,62534
2022,2,3110036,398489,337399,61090
2022,2,3110035,1342314,1516050,-173736
2022,2,3110033,712873,676891,35982
2022,2,3110031,60283,114728,-54445
2022,2,3110030,153008,160676,-7668
2022,2,3110029,3272392,2797651,474741
2022,2,3110028,2739676,2194303,545373
2022,2,3110027,391012,485421,-94409
2022,2,3110025,247921,341416,-93495
2022,2,3110024,331171,383317,-52146
2022,2,3110023,392319,554791,-162472
2022,2,3110022,577631,506824,70807
2022,2,3110021,1451559,1116679,334880
2022,2,3110020,2006874,1782273,224601
2022,2,3110018,509838,401736,108102
2022,2,3110017,504486,383586,120900
2022,2,3110016,37499,28293,9206
2022,2,3110014,65215,51508,13707
2022,2,3110012,628807,486149,142658
2022,2,3110010,172284,323216,-150932
2022,2,3110009,176832,198035,-21203
2022,2,3110008,1347671,1798438,-450767
2022,2,3110007,879354,768726,110628
2022,2,3110006,7100,20104,-13004
2022,2,3110005,136605,264171,-127566
2022,2,3110004,553295,475626,77669
2022,2,3110003,712418,536599,175819
2022,2,3110002,581730,508505,73225
2022,2,3110001,125747,163447,-37700
2022,1,3111089,801156,977123,-175967
2022,1,3111088,331682,474716,-143034
2022,1,3111087,212760,352467,-139707
2022,1,3111086,355474,397862,-42388
2022,1,3111085,850471,1053428,-202957
2022,1,3111084,186188,172885,13303
2022,1,3111083,992773,941065,51708
2022,1,3111082,184383,216925,-32542
2022,1,3111080,554752,486111,68641
2022,1,3111079,398257,395482,2775
2022,1,3111078,4210186,4011598,198588
2022,1,3111077,3481402,3349910,131492
2022,1,3111076,465820,542914,-77094
2022,1,3111075,1665098,1437929,227169
2022,1,3111074,648389,660200,-11811
2022,1,3111073,3739610,3174702,564908
2022,1,3111072,2201336,2398753,-197417
2022,1,3111071,443035,420634,22401
2022,1,3111070,1502175,1403488,98687
2022,1,3111069,2847926,2049084,798842
2022,1,3111068,232613,264142,-31529
2022,1,3111067,2754968,2904596,-149628
2022,1,3111066,1113036,914169,198867
2022,1,3111065,611025,831906,-220881
2022,1,3111064,603485,642857,-39372
2022,1,3111063,1455616,1583250,-127634
2022,1,3111062,872955,755499,117456
2022,1,3111061,3336378,2802825,533553
2022,1,3111060,3333806,3061576,272230
2022,1,3111059,3532807,3568360,-35553
2022,1,3111058,478737,588516,-109779
2022,1,3111057,986187,953924,32263
2022,1,3111056,325150,288247,36903
2022,1,3111055,17256,25884,-8628
2022,1,3111054,147792,164071,-16279
2022,1,3111053,1133900,1154519,-20619
2022,1,3111052,1165205,1141942,23263
2022,1,3111051,3000693,3132342,-131649
2022,1,3111049,1252683,1257330,-4647
2022,1,3111047,373952,529782,-155830
2022,1,3111046,2031413,2224460,-193047
2022,1,3111045,282422,266816,15606
2022,1,3111044,1425440,1618002,-192562
2022,1,3111043,756412,716427,39985
2022,1,3111042,1835977,1718922,117055
2022,1,3111040,642265,661442,-19177
2022,1,3111039,1021381,969382,51999
2022,1,3111038,404220,573737,-169517
2022,1,3111037,243349,262660,-19311
2022,1,3111036,380605,356478,24127
2022,1,3111035,879488,900964,-21476
2022,1,3111034,847741,872420,-24679
2022,1,3111033,46885,117509,-70624
2022,1,3111032,427983,505364,-77381
2022,1,3111031,982774,677560,305214
2022,1,3111030,1235619,793213,442406
2022,1,3111029,190553,222801,-32248
2022,1,3111028,929655,631679,297976
2022,1,3111027,924634,1423393,-498759
2022,1,3111026,902337,1002875,-100538
2022,1,3111025,989809,692133,297676
2022,1,3111024,396141,418521,-22380
2022,1,3111023,857392,722089,135303
2022,1,3111022,384493,506417,-121924
2022,1,3111021,2474376,2444419,29957
2022,1,3111020,231368,134824,96544
2022,1,3111019,1364796,1581365,-216569
2022,1,3111017,183727,337083,-153356
2022,1,3111016,664869,834620,-169751
2022,1,3111015,2014305,1950765,63540
2022,1,3111014,715736,534546,181190
2022,1,3111013,2353587,2315617,37970
2022,1,3111012,1038203,1515267,-477064
2022,1,3111011,38164,65278,-27114
2022,1,3111010,1922217,1990897,-68680
2022,1,3111009,234152,264647,-30495
2022,1,3111008,754410,691220,63190
2022,1,3111007,1259536,1250603,8933
2022,1,3111006,2376820,2454200,-77380
2022,1,3111005,1474491,1297239,177252
2022,1,3111004,2334280,2228673,105607
2022,1,3111003,2138505,2023518,114987
2022,1,3111001,50857,67604,-16747
2022,1,3110999,154658,165705,-11047
2022,1,3110997,2180094,2907688,-727594
2022,1,3110996,763227,609702,153525
2022,1,3110995,581913,638396,-56483
2022,1,3110994,439755,575363,-135608
2022,1,3110992,2019617,1841509,178108
2022,1,3110989,632049,707838,-75789
2022,1,3110988,128211,194928,-66717
2022,1,3110984,952631,909202,43429
2022,1,3110983,436972,465527,-28555
2022,1,3110982,373557,364979,8578
2022,1,3110981,415104,448677,-33573
2022,1,3110980,513628,440349,73279
2022,1,3110979,327912,286069,41843
2022,1,3110976,651122,762624,-111502
2022,1,3110975,274529,256700,17829
2022,1,3110974,426787,517911,-91124
2022,1,3110973,1133377,1015362,118015
2022,1,3110972,354565,299518,55047
2022,1,3110971,803559,1009456,-205897
2022,1,3110970,350891,372830,-21939
2022,1,3110969,766363,695200,71163
2022,1,3110968,295260,284944,10316
2022,1,3110967,673492,612603,60889
2022,1,3110966,1580844,1647088,-66244
2022,1,3110961,725302,1024371,-299069
2022,1,3110959,48944,110399,-61455
2022,1,3110958,561770,614991,-53221
2022,1,3110957,844555,822658,21897
2022,1,3110956,349522,361904,-12382
2022,1,3110955,2923300,2832154,91146
2022,1,3110954,410826,390408,20418
2022,1,3110953,406338,393597,12741
2022,1,3110952,241082,218257,22825
2022,1,3110951,532080,657086,-125006
2022,1,3110949,349095,311182,37913
2022,1,3110947,37980,53716,-15736
2022,1,3110945,31170,39373,-8203
2022,1,3110943,505905,527109,-21204
2022,1,3110942,1785549,1852723,-67174
2022,1,3110940,362731,333285,29446
2022,1,3110939,1924173,1846279,77894
2022,1,3110936,192389,195236,-2847
2022,1,3110935,537236,446691,90545
2022,1,3110934,441247,412719,28528
2022,1,3110932,239800,242483,-2683
2022,1,3110931,20789,23550,-2761
2022,1,3110930,591716,590202,1514
2022,1,3110929,1548382,1085136,463246
2022,1,3110926,1122465,1069828,52637
2022,1,3110925,613786,599537,14249
2022,1,3110924,448208,698072,-249864
2022,1,3110922,874396,700526,173870
2022,1,3110921,467622,305682,161940
2022,1,3110919,680565,747804,-67239
2022,1,3110918,1079318,1117252,-37934
2022,1,3110917,116101,117726,-1625
2022,1,3110916,844869,712898,131971
2022,1,3110915,195378,210321,-14943
2022,1,3110913,887405,1233346,-345941
2022,1,3110912,220089,216867,3222
2022,1,3110910,358519,351338,7181
2022,1,3110908,23636,106162,-82526
2022,1,3110907,873084,999797,-126713
2022,1,3110906,577893,438156,139737
2022,1,3110905,451390,604384,-152994
2022,1,3110904,249590,249126,464
2022,1,3110903,841182,1044620,-203438
2022,1,3110902,2338048,3212510,-874462
2022,1,3110901,1145970,1420137,-274167
2022,1,3110900,1918266,1419492,498774
2022,1,3110899,918722,776263,142459
2022,1,3110897,1545761,1824881,-279120
2022,1,3110896,195907,201310,-5403
2022,1,3110895,3993334,3639577,353757
2022,1,3110893,83776,57513,26263
2022,1,3110892,4758955,5098466,-339511
2022,1,3110891,166943,318031,-151088
2022,1,3110890,845689,636487,209202
2022,1,3110889,479274,392468,86806
2022,1,3110888,722734,860282,-137548
2022,1,3110887,421117,489028,-67911
2022,1,3110886,1158987,1042545,116442
2022,1,3110885,1552291,1793467,-241176
2022,1,3110884,757720,789378,-31658
2022,1,3110883,1140010,1431918,-291908
2022,1,3110882,1756755,1418944,337811
2022,1,3110881,4340212,3825408,514804
2022,1,3110880,504027,480999,23028
2022,1,3110879,297282,387106,-89824
2022,1,3110878,862806,628137,234669
2022,1,3110877,1372733,1208987,163746
2022,1,3110876,512218,577937,-65719
2022,1,3110875,189374,189130,244
2022,1,3110874,1908864,2105119,-196255
2022,1,3110873,641511,1111563,-470052
2022,1,3110872,874729,804412,70317
2022,1,3110871,744295,764550,-20255
2022,1,3110869,4398774,4020354,378420
2022,1,3110868,828765,1112093,-283328
2022,1,3110867,1313751,1137263,176488
2022,1,3110866,1312109,1041972,270137
2022,1,3110865,2370340,2262464,107876
2022,1,3110864,1854599,1812730,41869
2022,1,3110863,958232,1338290,-380058
2022,1,3110862,761475,773556,-12081
2022,1,3110861,2066088,1808452,257636
2022,1,3110860,483655,481951,1704
2022,1,3110859,592805,387887,204918
2022,1,3110858,503763,388315,115448
2022,1,3110857,1170324,1215918,-45594
2022,1,3110856,872839,856903,15936
2022,1,3110855,1292683,1846736,-554053
2022,1,3110854,390326,320201,70125
2022,1,3110853,1709781,1510169,199612
2022,1,3110852,722895,625687,97208
2022,1,3110851,1065152,943643,121509
2022,1,3110850,2513013,2872008,-358995
2022,1,3110849,1899239,1564925,334314
2022,1,3110848,1515412,1477820,37592
2022,1,3110847,930888,882676,48212
2022,1,3110846,2835167,3125438,-290271
2022,1,3110845,435638,438902,-3264
2022,1,3110843,476889,646966,-170077
2022,1,3110842,151930,187004,-35074
2022,1,3110841,1450760,1211343,239417
2022,1,3110840,784643,858417,-73774
2022,1,3110839,706545,878987,-172442
2022,1,3110838,148795,143080,5715
2022,1,3110837,1876731,1731947,144784
2022,1,3110836,1584153,2153380,-569227
2022,1,3110835,144947,173454,-28507
2022,1,3110833,578716,519987,58729
2022,1,3110832,561436,576118,-14682
2022,1,3110831,547612,493117,54495
2022,1,3110830,597684,813297,-215613
2022,1,3110829,754526,925703,-171177
2022,1,3110828,1789981,1696239,93742
2022,1,3110827,576666,609899,-33233
2022,1,3110826,715006,1028476,-313470
2022,1,3110825,2029731,2208194,-178463
2022,1,3110824,258166,334136,-75970
2022,1,3110823,652380,703137,-50757
2022,1,3110822,567501,716443,-148942
2022,1,3110821,1420552,1383840,36712
2022,1,3110820,885604,1044710,-159106
2022,1,3110819,901507,954808,-53301
2022,1,3110818,135463,156930,-21467
2022,1,3110817,328142,309129,19013
2022,1,3110816,694848,637988,56860
2022,1,3110815,1578356,1670138,-91782
2022,1,3110814,1469821,1304751,165070
2022,1,3110813,1288512,1156099,132413
2022,1,3110812,603720,675992,-72272
2022,1,3110811,421592,408603,12989
2022,1,3110810,1683668,1665556,18112
2022,1,3110809,390160,481082,-90922
2022,1,3110807,455823,453075,2748
2022,1,3110805,360008,334963,25045
2022,1,3110804,896606,897254,-648
2022,1,3110803,1357315,1434719,-77404
2022,1,3110802,604861,502978,101883
2022,1,3110800,150103,159706,-9603
2022,1,3110799,175307,247186,-71879
2022,1,3110798,134555,126278,8277
2022,1,3110796,85801,103319,-17518
2022,1,3110795,1185710,1127344,58366
2022,1,3110794,855712,662923,192789
2022,1,3110792,2299743,2322035,-22292
2022,1,3110791,75715,82347,-6632
2022,1,3110790,745092,1469911,-724819
2022,1,3110789,592847,497374,95473
2022,1,3110788,81853,79889,1964
2022,1,3110787,1324112,2007859,-683747
2022,1,3110786,403120,387273,15847
2022,1,3110785,1162005,1163322,-1317
2022,1,3110784,198549,205636,-7087
2022,1,3110783,218856,533114,-314258
2022,1,3110782,187304,390624,-203320
2022,1,3110781,1386590,1325329,61261
2022,1,3110780,325720,357835,-32115
2022,1,3110778,1249506,1396574,-147068
2022,1,3110777,242711,277577,-34866
2022,1,3110776,842430,902281,-59851
2022,1,3110775,297983,187934,110049
2022,1,3110774,509030,531090,-22060
2022,1,3110772,341283,320256,21027
2022,1,3110771,388516,342262,46254
2022,1,3110770,665265,949168,-283903
2022,1,3110769,507419,428732,78687
2022,1,3110768,221828,200886,20942
2022,1,3110767,272358,257702,14656
2022,1,3110766,1263682,1091584,172098
2022,1,3110765,321741,256292,65449
2022,1,3110762,1791134,1653717,137417
2022,1,3110760,737380,664660,72720
2022,1,3110758,377432,350682,26750
2022,1,3110757,210609,204107,6502
2022,1,3110756,217812,230565,-12753
2022,1,3110755,263103,330481,-67378
2022,1,3110754,1462191,1065043,397148
2022,1,3110753,1063024,1152222,-89198
2022,1,3110752,819578,1122808,-303230
2022,1,3110751,1019673,1127489,-107816
2022,1,3110750,834582,886993,-52411
2022,1,3110749,618282,586749,31533
2022,1,3110748,367146,471139,-103993
2022,1,3110747,190874,162204,28670
2022,1,3110746,225028,355753,-130725
2022,1,3110745,504244,779600,-275356
2022,1,3110744,1678409,2034756,-356347
2022,1,3110743,984537,840731,143806
2022,1,3110742,66535,65332,1203
2022,1,3110741,644872,490747,154125
2022,1,3110740,1592264,1402147,190117
2022,1,3110739,27620,28313,-693
2022,1,3110738,888646,817216,71430
2022,1,3110737,1619178,1395513,223665
2022,1,3110736,801900,686590,115310
2022,1,3110735,1172527,1193677,-21150
2022,1,3110734,21796,40338,-18542
2022,1,3110733,220608,288311,-67703
2022,1,3110732,356995,425329,-68334
2022,1,3110731,425475,322888,102587
2022,1,3110730,542033,470325,71708
2022,1,3110729,621273,591932,29341
2022,1,3110728,181904,231321,-49417
2022,1,3110727,362804,227071,135733
2022,1,3110726,261588,430198,-168610
2022,1,3110725,209818,261571,-51753
2022,1,3110724,633713,646542,-12829
2022,1,3110723,294358,293863,495
2022,1,3110722,344838,314239,30599
2022,1,3110721,1117754,889689,228065
2022,1,3110720,1020832,995406,25426
2022,1,3110719,276896,263851,13045
2022,1,3110718,956094,850789,105305
2022,1,3110717,3072496,3552451,-479955
2022,1,3110716,420076,357109,62967
2022,1,3110715,291772,348990,-57218
2022,1,3110714,1559617,1461261,98356
2022,1,3110713,2863409,2831583,31826
2022,1,3110712,2176182,1950116,226066
2022,1,3110711,1336367,1187881,148486
2022,1,3110710,2388705,3053527,-664822
2022,1,3110709,1334174,1110307,223867
2022,1,3110708,339760,402986,-63226
2022,1,3110707,1126870,1336361,-209491
2022,1,3110706,270649,252409,18240
2022,1,3110703,613918,634860,-20942
2022,1,3110702,1010563,725007,285556
2022,1,3110701,727055,406858,320197
2022,1,3110700,1019522,988166,31356
2022,1,3110699,517434,546180,-28746
2022,1,3110698,721841,700399,21442
2022,1,3110697,623488,542609,80879
2022,1,3110696,629694,739130,-109436
2022,1,3110695,1660574,1951090,-290516
2022,1,3110694,1911433,2199105,-287672
2022,1,3110693,104708,98151,6557
2022,1,3110692,1077617,839120,238497
2022,1,3110691,737252,996167,-258915
2022,1,3110690,1963429,1955698,7731
2022,1,3110689,675883,724391,-48508
2022,1,3110688,954027,848464,105563
2022,1,3110687,176837,173490,3347
2022,1,3110686,760077,931246,-171169
2022,1,3110684,49800,331847,-282047
2022,1,3110683,277553,283408,-5855
2022,1,3110681,29358,35095,-5737
2022,1,3110680,236561,333989,-97428
2022,1,3110679,253373,273608,-20235
2022,1,3110678,164185,225058,-60873
2022,1,3110677,187431,274944,-87513
2022,1,3110676,464627,524479,-59852
2022,1,3110675,1739619,1800297,-60678
2022,1,3110673,592521,962695,-370174
2022,1,3110672,691233,692634,-1401
2022,1,3110671,2159932,2109797,50135
2022,1,3110670,1653313,1512905,140408
2022,1,3110668,1889077,1709176,179901
2022,1,3110666,197523,305682,-108159
2022,1,3110665,1201859,1647712,-445853
2022,1,3110664,233563,222617,10946
2022,1,3110663,262538,344218,-81680
2022,1,3110662,2758243,2207571,550672
2022,1,3110661,290656,382172,-91516
2022,1,3110660,666931,638169,28762
2022,1,3110659,5074298,5057661,16637
2022,1,3110658,943401,1113395,-169994
2022,1,3110657,663164,412616,250548
2022,1,3110656,6296885,5633143,663742
2022,1,3110655,363469,354619,8850
2022,1,3110654,2485026,3591253,-1106227
2022,1,3110653,1036098,801226,234872
2022,1,3110652,303768,305475,-1707
2022,1,3110651,554056,1200012,-645956
2022,1,3110650,80512,231301,-150789
2022,1,3110649,992493,1023613,-31120
2022,1,3110647,2499254,2403171,96083
2022,1,3110646,1823411,2210694,-387283
2022,1,3110645,1326545,1577832,-251287
2022,1,3110644,94755,99262,-4507
2022,1,3110643,784535,699328,85207
2022,1,3110641,252779,526535,-273756
2022,1,3110640,587910,526632,61278
2022,1,3110639,404448,962549,-558101
2022,1,3110638,2272492,2146508,125984
2022,1,3110637,196799,210660,-13861
2022,1,3110636,642087,490176,151911
2022,1,3110635,287451,700497,-413046
2022,1,3110634,1983977,2242383,-258406
2022,1,3110633,57655,121168,-63513
2022,1,3110632,709151,503117,206034
2022,1,3110631,635087,710844,-75757
2022,1,3110630,1763573,2153720,-390147
2022,1,3110629,160018,130428,29590
2022,1,3110628,266591,313381,-46790
2022,1,3110627,1239504,1279723,-40219
2022,1,3110626,1546857,1287307,259550
2022,1,3110625,564852,831550,-266698
2022,1,3110624,531063,602412,-71349
2022,1,3110622,503154,521354,-18200
2022,1,3110621,267785,355177,-87392
2022,1,3110620,2280480,2192603,87877
2022,1,3110619,347525,403548,-56023
2022,1,3110618,1603362,1589260,14102
2022,1,3110617,580349,528073,52276
2022,1,3110616,241463,182098,59365
2022,1,3110615,232378,296390,-64012
2022,1,3110614,524893,796930,-272037
2022,1,3110613,258270,211596,46674
2022,1,3110612,2142120,2569603,-427483
2022,1,3110611,1168089,1183835,-15746
2022,1,3110609,999477,920809,78668
2022,1,3110608,1650608,1513265,137343
2022,1,3110607,161434,170793,-9359
2022,1,3110606,1465819,1669061,-203242
2022,1,3110605,45096,146150,-101054
2022,1,3110604,1175059,1281354,-106295
2022,1,3110603,84479,89753,-5274
2022,1,3110602,194982,198413,-3431
2022,1,3110601,1442023,1558323,-116300
2022,1,3110600,570081,642795,-72714
2022,1,3110599,1150199,916919,233280
2022,1,3110598,564850,488768,76082
2022,1,3110597,1254586,990974,263612
2022,1,3110596,632843,534170,98673
2022,1,3110595,560880,941747,-380867
2022,1,3110594,364475,492924,-128449
2022,1,3110593,1136387,1146538,-10151
2022,1,3110592,254239,239607,14632
2022,1,3110591,1458461,1440029,18432
2022,1,3110590,1528265,1390437,137828
2022,1,3110589,107084,223755,-116671
2022,1,3110588,1037951,1214381,-176430
2022,1,3110587,895965,791816,104149
2022,1,3110586,1805522,1341083,464439
2022,1,3110585,139522,222289,-82767
2022,1,3110584,102282,134735,-32453
2022,1,3110583,382664,365967,16697
2022,1,3110582,531648,581896,-50248
2022,1,3110580,761807,538925,222882
2022,1,3110579,315125,405763,-90638
2022,1,3110578,1260925,1405559,-144634
2022,1,3110577,618820,614846,3974
2022,1,3110576,1164745,1106228,58517
2022,1,3110575,1075024,917709,157315
2022,1,3110574,48543,70704,-22161
2022,1,3110573,98218,96626,1592
2022,1,3110572,1826283,1620100,206183
2022,1,3110571,520824,612683,-91859
2022,1,3110570,214525,187091,27434
2022,1,3110569,927919,888287,39632
2022,1,3110568,315024,282379,32645
2022,1,3110567,278686,263746,14940
2022,1,3110566,1434633,1455511,-20878
2022,1,3110565,412428,330447,81981
2022,1,3110564,710994,563297,147697
2022,1,3110563,204957,217666,-12709
2022,1,3110562,1017850,1172132,-154282
2022,1,3110561,754455,815093,-60638
2022,1,3110560,1100455,936248,164207
2022,1,3110559,880143,720082,160061
2022,1,3110558,2454084,2324109,129975
2022,1,3110557,902093,987321,-85228
2022,1,3110555,189282,193844,-4562
2022,1,3110554,883692,1167312,-283620
2022,1,3110553,810763,671869,138894
2022,1,3110552,790608,974430,-183822
2022,1,3110551,1499466,1442615,56851
2022,1,3110550,1723047,1763742,-40695
2022,1,3110549,1255035,1271817,-16782
2022,1,3110548,1133676,1090860,42816
2022,1,3110547,828527,802572,25955
2022,1,3110546,776498,743268,33230
2022,1,3110545,586197,590453,-4256
2022,1,3110544,5132483,4836437,296046
2022,1,3110543,86455,103061,-16606
2022,1,3110542,1556603,1540782,15821
2022,1,3110541,1319105,1569607,-250502
2022,1,3110540,554113,664270,-110157
2022,1,3110539,255085,251467,3618
2022,1,3110538,364928,417272,-52344
2022,1,3110537,425407,434967,-9560
2022,1,3110536,100646,118399,-17753
2022,1,3110535,1121772,1045106,76666
2022,1,3110534,625392,498097,127295
2022,1,3110533,4303070,4282557,20513
2022,1,3110532,1052107,845029,207078
2022,1,3110529,1085380,1155213,-69833
2022,1,3110528,944919,798797,146122
2022,1,3110527,548834,437549,111285
2022,1,3110526,127018,122269,4749
2022,1,3110525,342578,391795,-49217
2022,1,3110524,118661,113783,4878
2022,1,3110523,110475,107227,3248
2022,1,3110522,210019,363582,-153563
2022,1,3110521,675947,645874,30073
2022,1,3110520,513769,540167,-26398
2022,1,3110519,1003596,980293,23303
2022,1,3110517,167797,245859,-78062
2022,1,3110515,387009,300298,86711
2022,1,3110514,666617,555140,111477
2022,1,3110513,360436,357911,2525
2022,1,3110512,531119,639447,-108328
2022,1,3110511,871787,800360,71427
2022,1,3110510,1007406,898976,108430
2022,1,3110509,934154,889923,44231
2022,1,3110508,503053,624038,-120985
2022,1,3110507,1447091,1755039,-307948
2022,1,3110506,250872,183112,67760
2022,1,3110505,68720,60554,8166
2022,1,3110503,1788092,1544053,244039
2022,1,3110502,1699289,1519614,179675
2022,1,3110501,260520,270703,-10183
2022,1,3110500,183673,226946,-43273
2022,1,3110499,2388937,2146731,242206
2022,1,3110498,2110623,1998477,112146
2022,1,3110496,1065616,843949,221667
2022,1,3110495,1368189,1612225,-244036
2022,1,3110493,426790,519223,-92433
2022,1,3110491,75733,114892,-39159
2022,1,3110490,599913,789166,-189253
2022,1,3110489,585565,432740,152825
2022,1,3110488,518635,468766,49869
2022,1,3110487,119574,120121,-547
2022,1,3110486,578309,433318,144991
2022,1,3110485,572338,718186,-145848
2022,1,3110484,1750765,1964521,-213756
2022,1,3110483,690555,643539,47016
2022,1,3110482,313935,450558,-136623
2022,1,3110481,2530915,1827873,703042
2022,1,3110480,407248,617444,-210196
2022,1,3110479,1217422,1082965,134457
2022,1,3110478,455680,732079,-276399
2022,1,3110477,368966,507648,-138682
2022,1,3110476,138349,149122,-10773
2022,1,3110475,704801,645563,59238
2022,1,3110474,1062319,892049,170270
2022,1,3110473,1851246,1704894,146352
2022,1,3110472,1170450,1192882,-22432
2022,1,3110471,1587850,1639501,-51651
2022,1,3110470,646116,646918,-802
2022,1,3110469,1655192,1976021,-320829
2022,1,3110468,3615451,3063968,551483
2022,1,3110467,987747,926681,61066
2022,1,3110466,1077052,1129892,-52840
2022,1,3110465,1308600,1559523,-250923
2022,1,3110464,501546,573432,-71886
2022,1,3110463,571429,476406,95023
2022,1,3110462,1094456,1347295,-252839
2022,1,3110461,226904,370963,-144059
2022,1,3110460,1735294,1567720,167574
2022,1,3110459,959774,1207968,-248194
2022,1,3110458,1187446,1595174,-407728
2022,1,3110457,777000,752128,24872
2022,1,3110456,1572831,1679176,-106345
2022,1,3110455,1656388,1520974,135414
2022,1,3110454,1339365,1065192,274173
2022,1,3110453,1913843,1622750,291093
2022,1,3110452,958076,912062,46014
2022,1,3110451,1424409,1402204,22205
2022,1,3110450,1952684,2097474,-144790
2022,1,3110449,978730,1007855,-29125
2022,1,3110448,639549,907694,-268145
2022,1,3110447,545165,417351,127814
2022,1,3110446,304581,408634,-104053
2022,1,3110444,105194,144866,-39672
2022,1,3110443,88378,121901,-33523
2022,1,3110442,162981,171670,-8689
2022,1,3110441,671089,1247257,-576168
2022,1,3110440,387368,971435,-584067
2022,1,3110439,1216559,784971,431588
2022,1,3110438,1548050,1590076,-42026
2022,1,3110437,1488807,1506580,-17773
2022,1,3110436,536269,416101,120168
2022,1,3110435,97642,99160,-1518
2022,1,3110434,482044,482723,-679
2022,1,3110433,1362916,1433805,-70889
2022,1,3110432,352481,442727,-90246
2022,1,3110431,465001,499337,-34336
2022,1,3110429,2069962,1979992,89970
2022,1,3110428,4247784,3810928,436856
2022,1,3110427,107648,168630,-60982
2022,1,3110426,1843692,1621835,221857
2022,1,3110425,667577,1201299,-533722
2022,1,3110424,2821641,2346680,474961
2022,1,3110423,309199,289397,19802
2022,1,3110422,919952,810879,109073
2022,1,3110421,349411,524348,-174937
2022,1,3110420,615639,655107,-39468
2022,1,3110419,855186,1193416,-338230
2022,1,3110418,657870,741813,-83943
2022,1,3110417,449254,376079,73175
2022,1,3110416,945823,787225,158598
2022,1,3110415,2096186,2043461,52725
2022,1,3110413,115052,141939,-26887
2022,1,3110412,175107,130640,44467
2022,1,3110411,546205,507444,38761
2022,1,3110410,750572,719160,31412
2022,1,3110409,737887,815932,-78045
2022,1,3110408,417037,413618,3419
2022,1,3110407,901780,1001930,-100150
2022,1,3110406,212767,275619,-62852
2022,1,3110405,1516309,2066791,-550482
2022,1,3110404,3382762,3840485,-457723
2022,1,3110403,1711165,1671373,39792
2022,1,3110402,732042,889672,-157630
2022,1,3110401,186246,202860,-16614
2022,1,3110400,1291778,1422734,-130956
2022,1,3110399,1907453,2146488,-239035
2022,1,3110398,890803,818293,72510
2022,1,3110397,1758144,1830418,-72274
2022,1,3110396,1059738,958178,101560
2022,1,3110395,288812,283088,5724
2022,1,3110394,1132383,1087521,44862
2022,1,3110393,63792,62534,1258
2022,1,3110392,160532,137014,23518
2022,1,3110391,567235,601899,-34664
2022,1,3110390,516727,1096284,-579557
2022,1,3110389,397236,405164,-7928
2022,1,3110388,688949,693220,-4271
2022,1,3110387,1732082,1441488,290594
2022,1,3110383,115058,336365,-221307
2022,1,3110382,615167,530218,84949
2022,1,3110381,439479,370779,68700
2022,1,3110380,746049,804810,-58761
2022,1,3110379,158889,150763,8126
2022,1,3110378,867314,943931,-76617
2022,1,3110377,680253,679551,702
2022,1,3110376,3312414,4199153,-886739
2022,1,3110375,658301,470550,187751
2022,1,3110374,2570952,2552403,18549
2022,1,3110373,1302305,1236857,65448
2022,1,3110372,1773601,1614961,158640
2022,1,3110371,710555,881839,-171284
2022,1,3110370,1315393,1973048,-657655
2022,1,3110369,1158093,1409728,-251635
2022,1,3110368,2715449,2441397,274052
2022,1,3110367,1440148,1358232,81916
2022,1,3110366,635288,727342,-92054
2022,1,3110365,1768860,1819817,-50957
2022,1,3110364,1470955,1934399,-463444
2022,1,3110363,304623,424166,-119543
2022,1,3110362,908882,1116093,-207211
2022,1,3110361,959613,899698,59915
2022,1,3110360,1340927,1722783,-381856
2022,1,3110359,1039581,1237086,-197505
2022,1,3110358,995883,1311094,-315211
2022,1,3110357,1049211,1102827,-53616
2022,1,3110356,1141481,1024113,117368
2022,1,3110355,1386520,1245730,140790
2022,1,3110354,85000,103853,-18853
2022,1,3110353,801653,776870,24783
2022,1,3110352,1656793,1550855,105938
2022,1,3110351,840115,827762,12353
2022,1,3110350,538166,728889,-190723
2022,1,3110349,653527,525509,128018
2022,1,3110348,2171905,1881473,290432
2022,1,3110346,603356,515413,87943
2022,1,3110345,715262,719010,-3748
2022,1,3110344,336941,293508,43433
2022,1,3110343,913713,1025454,-111741
2022,1,3110342,1032120,1076668,-44548
2022,1,3110341,218853,351337,-132484
2022,1,3110340,322215,308447,13768
2022,1,3110337,501500,484993,16507
2022,1,3110336,339367,714594,-375227
2022,1,3110335,1377519,1282237,95282
2022,1,3110334,1721872,1579369,142503
2022,1,3110333,736170,1012055,-275885
2022,1,3110332,215805,188958,26847
2022,1,3110331,1175654,1268030,-92376
2022,1,3110330,933854,788135,145719
2022,1,3110329,424152,314124,110028
2022,1,3110328,1059139,798507,260632
2022,1,3110327,883823,1184644,-300821
2022,1,3110326,524046,382848,141198
2022,1,3110325,1064092,719117,344975
2022,1,3110323,1573688,1404119,169569
2022,1,3110322,800627,978801,-178174
2022,1,3110320,188702,220499,-31797
2022,1,3110319,1140475,1254267,-113792
2022,1,3110318,1145888,1026202,119686
2022,1,3110317,636654,510319,126335
2022,1,3110316,2927134,3215932,-288798
2022,1,3110315,1611567,1484503,127064
2022,1,3110314,714432,740570,-26138
2022,1,3110313,1220435,1143197,77238
2022,1,3110312,514001,459556,54445
2022,1,3110310,38404,127987,-89583
2022,1,3110309,369629,417069,-47440
2022,1,3110308,939360,716532,222828
2022,1,3110307,734175,783670,-49495
2022,1,3110306,101979,127135,-25156
2022,1,3110305,1910246,1966616,-56370
2022,1,3110304,887393,886229,1164
2022,1,3110303,1306137,1585247,-279110
2022,1,3110302,249692,616020,-366328
2022,1,3110301,1550414,1569008,-18594
2022,1,3110300,2919560,3187620,-268060
2022,1,3110299,1959601,2032604,-73003
2022,1,3110298,363757,279718,84039
2022,1,3110297,2064839,2098697,-33858
2022,1,3110296,981970,845688,136282
2022,1,3110295,938742,1144067,-205325
2022,1,3110294,1632401,1589473,42928
2022,1,3110293,1522164,1453322,68842
2022,1,3110292,308564,287389,21175
2022,1,3110291,2161113,2186310,-25197
2022,1,3110290,214088,186604,27484
2022,1,3110289,1411876,1260580,151296
2022,1,3110288,321410,303065,18345
2022,1,3110287,213108,245832,-32724
2022,1,3110286,670661,567851,102810
2022,1,3110285,126816,213089,-86273
2022,1,3110284,96917,103443,-6526
2022,1,3110283,148424,151503,-3079
2022,1,3110282,38033,33503,4530
2022,1,3110281,78674,75668,3006
2022,1,3110280,280837,196429,84408
2022,1,3110278,837888,1409387,-571499
2022,1,3110277,1212133,1377206,-165073
2022,1,3110276,46668,50028,-3360
2022,1,3110275,435785,432973,2812
2022,1,3110274,1309948,1427078,-117130
2022,1,3110273,799232,672645,126587
2022,1,3110272,1309739,1459724,-149985
2022,1,3110271,45877,42109,3768
2022,1,3110270,463660,436931,26729
2022,1,3110269,463239,481489,-18250
2022,1,3110268,531690,694896,-163206
2022,1,3110267,1471041,1623469,-152428
2022,1,3110266,1679768,1728624,-48856
2022,1,3110265,488125,427284,60841
2022,1,3110264,3149906,2712333,437573
2022,1,3110263,1376226,2309310,-933084
2022,1,3110262,1801314,1466883,334431
2022,1,3110261,1557066,1574553,-17487
2022,1,3110260,1580559,1092839,487720
2022,1,3110259,1446392,1404722,41670
2022,1,3110258,670941,1193125,-522184
2022,1,3110257,1919365,2140121,-220756
2022,1,3110256,1706158,1569727,136431
2022,1,3110255,2064568,2812822,-748254
2022,1,3110254,3744106,3927012,-182906
2022,1,3110253,817253,1010147,-192894
2022,1,3110252,913907,695669,218238
2022,1,3110251,743828,878351,-134523
2022,1,3110250,463286,672490,-209204
2022,1,3110249,2181031,1672440,508591
2022,1,3110248,581919,514392,67527
2022,1,3110247,2255983,1918583,337400
2022,1,3110246,1478768,943046,535722
2022,1,3110245,544282,566886,-22604
2022,1,3110244,891278,897989,-6711
2022,1,3110243,1029903,1398104,-368201
2022,1,3110242,772554,876252,-103698
2022,1,3110241,1177077,1204180,-27103
2022,1,3110240,721470,645507,75963
2022,1,3110238,92557,175832,-83275
2022,1,3110237,1040998,1335800,-294802
2022,1,3110236,2056319,2041698,14621
2022,1,3110234,303753,384338,-80585
2022,1,3110233,1223305,1738136,-514831
2022,1,3110232,885771,717438,168333
2022,1,3110230,1054551,848075,206476
2022,1,3110229,1843810,1578490,265320
2022,1,3110228,1633992,1738840,-104848
2022,1,3110227,633118,523703,109415
2022,1,3110226,2563633,2953254,-389621
2022,1,3110225,392207,638161,-245954
2022,1,3110224,581274,533028,48246
2022,1,3110221,272958,393668,-120710
2022,1,3110220,1106471,1123026,-16555
2022,1,3110219,1674167,1558336,115831
2022,1,3110218,1299626,1123065,176561
2022,1,3110217,645947,641525,4422
2022,1,3110216,355654,429902,-74248
2022,1,3110215,714400,778578,-64178
2022,1,3110214,1412484,1046912,365572
2022,1,3110213,513551,451047,62504
2022,1,3110212,1093255,879383,213872
2022,1,3110211,2410613,2449264,-38651
2022,1,3110210,2248291,2131035,117256
2022,1,3110209,348032,401034,-53002
2022,1,3110208,371206,379202,-7996
2022,1,3110207,576119,536778,39341
2022,1,3110206,1584961,1696815,-111854
2022,1,3110205,1891890,1788072,103818
2022,1,3110204,1509260,1226713,282547
2022,1,3110203,671987,660979,11008
2022,1,3110201,148039,121198,26841
2022,1,3110200,451320,541446,-90126
2022,1,3110199,446848,526010,-79162
2022,1,3110197,297386,238357,59029
2022,1,3110195,1505207,1514399,-9192
2022,1,3110194,569808,616553,-46745
2022,1,3110193,748087,800467,-52380
2022,1,3110191,1081274,1239439,-158165
2022,1,3110190,1374868,1216754,158114
2022,1,3110189,1024500,861223,163277
2022,1,3110188,957277,826744,130533
2022,1,3110187,2854152,3019388,-165236
2022,1,3110186,147066,206373,-59307
2022,1,3110185,758141,496598,261543
2022,1,3110184,275281,218803,56478
2022,1,3110183,468997,483606,-14609
2022,1,3110182,805957,739797,66160
2022,1,3110181,1251977,1154602,97375
2022,1,3110180,237413,273502,-36089
2022,1,3110179,535492,453963,81529
2022,1,3110178,336858,303896,32962
2022,1,3110177,95867,173977,-78110
2022,1,3110176,1621398,1478146,143252
2022,1,3110175,1226808,1678942,-452134
2022,1,3110174,933735,849138,84597
2022,1,3110173,403837,475899,-72062
2022,1,3110172,798611,971018,-172407
2022,1,3110171,324081,590759,-266678
2022,1,3110170,3125304,2812012,313292
2022,1,3110169,602704,603194,-490
2022,1,3110168,459439,1044302,-584863
2022,1,3110167,1872530,1542653,329877
2022,1,3110166,2101495,2155780,-54285
2022,1,3110165,748076,1179203,-431127
2022,1,3110164,433935,510782,-76847
2022,1,3110163,864908,625246,239662
2022,1,3110162,527974,589278,-61304
2022,1,3110161,993551,1536837,-543286
2022,1,3110160,758868,687004,71864
2022,1,3110159,3413021,3699353,-286332
2022,1,3110158,2708025,2295836,412189
2022,1,3110157,1314215,1154402,159813
2022,1,3110156,1094840,1206281,-111441
2022,1,3110155,880281,816064,64217
2022,1,3110154,2136260,2074255,62005
2022,1,3110153,296376,540206,-243830
2022,1,3110152,272470,319843,-47373
2022,1,3110151,1437198,1410162,27036
2022,1,3110150,1934707,1769646,165061
2022,1,3110149,234129,276283,-42154
2022,1,3110148,513402,408750,104652
2022,1,3110147,933903,1558276,-624373
2022,1,3110146,1676295,1601888,74407
2022,1,3110144,382894,377781,5113
2022,1,3110142,2003801,1789860,213941
2022,1,3110141,1906744,1466609,440135
2022,1,3110140,2162631,2099298,63333
2022,1,3110139,2099296,2033106,66190
2022,1,3110138,1312425,1249275,63150
2022,1,3110137,1413716,1282911,130805
2022,1,3110136,1237660,1033832,203828
2022,1,3110135,217767,313210,-95443
2022,1,3110134,1485664,1816122,-330458
2022,1,3110133,449734,497982,-48248
2022,1,3110132,622662,712185,-89523
2022,1,3110131,744737,898642,-153905
2022,1,3110130,503785,451792,51993
2022,1,3110129,236411,258452,-22041
2022,1,3110128,1348298,1822952,-474654
2022,1,3110127,152035,136470,15565
2022,1,3110126,314990,184226,130764
2022,1,3110125,934025,795349,138676
2022,1,3110124,481584,485802,-4218
2022,1,3110123,840282,808794,31488
2022,1,3110122,318777,335583,-16806
2022,1,3110121,139177,189600,-50423
2022,1,3110120,395902,628894,-232992
2022,1,3110118,609148,614458,-5310
2022,1,3110117,514371,715333,-200962
2022,1,3110116,684592,802073,-117481
2022,1,3110115,875295,852717,22578
2022,1,3110114,464219,372756,91463
2022,1,3110113,167785,175698,-7913
2022,1,3110112,906367,701104,205263
2022,1,3110110,1073961,969953,104008
2022,1,3110109,306305,407288,-100983
2022,1,3110107,113240,177695,-64455
2022,1,3110105,896634,961098,-64464
2022,1,3110104,1286675,1141579,145096
2022,1,3110103,251709,313647,-61938
2022,1,3110102,623105,539566,83539
2022,1,3110099,340566,310892,29674
2022,1,3110098,85153,95947,-10794
2022,1,3110096,241705,300529,-58824
2022,1,3110095,480075,552796,-72721
2022,1,3110093,2553981,2535714,18267
2022,1,3110092,697812,1029537,-331725
2022,1,3110090,653577,617514,36063
2022,1,3110089,530103,541323,-11220
2022,1,3110088,407735,400266,7469
2022,1,3110087,259423,231257,28166
2022,1,3110085,1314155,1332486,-18331
2022,1,3110084,929060,982100,-53040
2022,1,3110083,95672,122559,-26887
2022,1,3110082,327608,324211,3397
2022,1,3110081,1872990,1708798,164192
2022,1,3110080,1593111,2027586,-434475
2022,1,3110079,2202005,2494673,-292668
2022,1,3110078,119148,107451,11697
2022,1,3110077,541898,454826,87072
2022,1,3110075,854739,896090,-41351
2022,1,3110074,773501,782171,-8670
2022,1,3110073,116073,125342,-9269
2022,1,3110071,40526,52157,-11631
2022,1,3110070,59147,70427,-11280
2022,1,3110069,2365920,2049621,316299
2022,1,3110068,1627882,1710332,-82450
2022,1,3110067,2526097,2228311,297786
2022,1,3110066,1341746,1479617,-137871
2022,1,3110065,57193,80445,-23252
2022,1,3110064,1569086,1436093,132993
2022,1,3110063,916101,857937,58164
2022,1,3110062,849119,1033980,-184861
2022,1,3110061,1316387,1492207,-175820
2022,1,3110060,615859,1108777,-492918
2022,1,3110059,879372,519704,359668
2022,1,3110058,1487396,1465309,22087
2022,1,3110057,852090,863578,-11488
2022,1,3110056,2002257,2159623,-157366
2022,1,3110055,504882,498949,5933
2022,1,3110054,1023915,1002652,21263
2022,1,3110053,1114946,1189323,-74377
2022,1,3110052,565644,651445,-85801
2022,1,3110051,888344,758074,130270
2022,1,3110050,401341,408070,-6729
2022,1,3110049,613576,714615,-101039
2022,1,3110048,843451,825931,17520
2022,1,3110047,582715,623798,-41083
2022,1,3110045,614926,596362,18564
2022,1,3110043,740893,745718,-4825
2022,1,3110042,166938,166225,713
2022,1,3110041,272099,266980,5119
2022,1,3110040,170377,152934,17443
2022,1,3110039,89617,76530,13087
2022,1,3110037,891719,881043,10676
2022,1,3110036,395618,327133,68485
2022,1,3110035,1265171,1507449,-242278
2022,1,3110033,709911,674600,35311
2022,1,3110031,62927,122942,-60015
2022,1,3110030,141066,158588,-17522
2022,1,3110029,3242822,2887275,355547
2022,1,3110028,2624455,2073520,550935
2022,1,3110027,371364,475450,-104086
2022,1,3110025,211926,387657,-175731
2022,1,3110024,316429,377983,-61554
2022,1,3110023,369722,483493,-113771
2022,1,3110022,557111,495027,62084
2022,1,3110021,1315429,1059721,255708
2022,1,3110020,1829358,1750161,79197
2022,1,3110018,436602,400330,36272
2022,1,3110017,439142,341142,98000
2022,1,3110016,32611,29382,3229
2022,1,3110014,52469,49423,3046
2022,1,3110012,571544,465290,106254
2022,1,3110010,176332,322424,-146092
2022,1,3110009,177855,197242,-19387
2022,1,3110008,1242028,1760278,-518250
2022,1,3110007,917103,784962,132141
2022,1,3110006,6845,19878,-13033
2022,1,3110005,125167,271751,-146584
2022,1,3110004,525499,473824,51675
2022,1,3110003,729450,546676,182774
2022,1,3110002,529340,500383,28957
2022,1,3110001,128326,166405,-38079
2023,3,3111089,889488,878654,10834
2023,3,3111088,291729,321762,-30033
2023,3,3111087,188169,198694,-10525
2023,3,3111086,417454,350377,67077
2023,3,3111085,812962,788769,24193
2023,3,3111084,193211,187662,5549
2023,3,3111083,813934,891296,-77362
2023,3,3111082,149464,139955,9509
2023,3,3111080,610353,526180,84173
2023,3,3111079,386887,373988,12899
2023,3,3111078,3945714,3942492,3222
2023,3,3111077,3343166,3238965,104201
2023,3,3111076,384125,426472,-42347
2023,3,3111075,1418613,1479581,-60968
2023,3,3111074,561826,571089,-9263
2023,3,3111073,3637953,3616347,21606
2023,3,3111072,1789574,2221743,-432169
2023,3,3111071,575139,574680,459
2023,3,3111070,1419321,1339798,79523
2023,3,3111069,2528194,2441952,86242
2023,3,3111068,258160,260242,-2082
2023,3,3111067,2451733,2548716,-96983
2023,3,3111066,1257859,1242140,15719
2023,3,3111065,557523,576814,-19291
2023,3,3111064,501779,533505,-31726
2023,3,3111063,1433016,1384256,48760
2023,3,3111062,925314,895294,30020
2023,3,3111061,2365677,2994162,-628485
2023,3,3111060,3413034,3264988,148046
2023,3,3111059,3305122,3349057,-43935
2023,3,3111058,493388,472430,20958
2023,3,3111057,959872,811654,148218
2023,3,3111056,326850,346190,-19340
2023,3,3111055,31262,28638,2624
2023,3,3111054,206569,204063,2506
2023,3,3111053,1138880,1087203,51677
2023,3,3111052,1284556,1544101,-259545
2023,3,3111051,2785852,2835280,-49428
2023,3,3111049,1310633,1204350,106283
2023,3,3111047,283157,272908,10249
2023,3,3111046,1947153,2007172,-60019
2023,3,3111045,292629,271486,21143
2023,3,3111044,1290823,1431549,-140726
2023,3,3111043,620258,691984,-71726
2023,3,3111042,2158371,1950369,208002
2023,3,3111040,682145,625027,57118
2023,3,3111039,997134,998509,-1375
2023,3,3111038,649172,531114,118058
2023,3,3111037,258402,240213,18189
2023,3,3111036,340636,355861,-15225
2023,3,3111035,629987,814307,-184320
2023,3,3111034,840528,805453,35075
2023,3,3111033,45295,46429,-1134
2023,3,3111032,361478,352244,9234
2023,3,3111031,1025475,960284,65191
2023,3,3111030,1338013,1461456,-123443
2023,3,3111029,177322,178925,-1603
2023,3,3111028,886437,890770,-4333
2023,3,3111027,945696,936608,9088
2023,3,3111026,985201,918390,66811
2023,3,3111025,962236,800771,161465
2023,3,3111024,385626,449227,-63601
2023,3,3111023,881836,893606,-11770
2023,3,3111022,388725,386375,2350
2023,3,3111021,2539493,2481161,58332
2023,3,3111020,240622,219125,21497
2023,3,3111019,1435246,1458605,-23359
2023,3,3111017,156652,183746,-27094
2023,3,3111016,703762,707393,-3631
2023,3,3111015,1722183,1962445,-240262
2023,3,3111014,730295,713342,16953
2023,3,3111013,2290459,2524585,-234126
2023,3,3111012,909011,1004349,-95338
2023,3,3111011,42549,36391,6158
2023,3,3111010,1622040,1650793,-28753
2023,3,3111009,236008,254918,-18910
2023,3,3111008,637698,746483,-108785
2023,3,3111007,1123100,1191709,-68609
2023,3,3111006,1982161,2108784,-126623
2023,3,3111005,1456363,1413660,42703
2023,3,3111004,2287157,2256460,30697
2023,3,3111003,2169443,2119812,49631
2023,3,3111001,71822,47124,24698
2023,3,3110999,160763,157088,3675
2023,3,3110997,1832284,1888318,-56034
2023,3,3110996,869393,799890,69503
2023,3,3110995,639907,596736,43171
2023,3,3110994,470788,476618,-5830
2023,3,3110992,2097466,2035887,61579
2023,3,3110989,630607,658189,-27582
2023,3,3110988,136442,124760,11682
2023,3,3110984,900682,918569,-17887
2023,3,3110983,441784,443655,-1871
2023,3,3110982,361647,357894,3753
2023,3,3110981,517242,436170,81072
2023,3,3110980,520810,518402,2408
2023,3,3110979,322009,318689,3320
2023,3,3110976,784403,746138,38265
2023,3,3110975,323511,311878,11633
2023,3,3110974,371230,428288,-57058
2023,3,3110973,941400,1082489,-141089
2023,3,3110972,284515,354718,-70203
2023,3,3110971,760816,805553,-44737
2023,3,3110970,344447,347094,-2647
2023,3,3110969,837381,790274,47107
2023,3,3110968,291299,298809,-7510
2023,3,3110967,568907,667907,-99000
2023,3,3110966,1697885,1609358,88527
2023,3,3110961,1189933,914569,275364
2023,3,3110959,110335,106040,4295
2023,3,3110958,634895,637015,-2120
2023,3,3110957,854553,869111,-14558
2023,3,3110956,537187,555959,-18772
2023,3,3110955,2670294,2797389,-127095
2023,3,3110954,493510,481105,12405
2023,3,3110953,432245,408958,23287
2023,3,3110952,202975,215645,-12670
2023,3,3110951,519049,594226,-75177
2023,3,3110949,369504,369427,77
2023,3,3110947,12153,33852,-21699
2023,3,3110945,30877,31197,-320
2023,3,3110943,462940,474718,-11778
2023,3,3110942,1628659,1740794,-112135
2023,3,3110940,393121,389783,3338
2023,3,3110939,1851141,1938571,-87430
2023,3,3110936,193963,206349,-12386
2023,3,3110935,684850,617358,67492
2023,3,3110934,439598,434343,5255
2023,3,3110932,243373,234204,9169
2023,3,3110931,24971,24383,588
2023,3,3110930,465312,508408,-43096
2023,3,3110929,1624227,1423029,201198
2023,3,3110926,903572,1060237,-156665
2023,3,3110925,544198,577780,-33582
2023,3,3110924,386579,457543,-70964
2023,3,3110922,932788,829162,103626
2023,3,3110921,320166,336319,-16153
2023,3,3110919,575879,597130,-21251
2023,3,3110918,993453,1020984,-27531
2023,3,3110917,99680,105202,-5522
2023,3,3110916,756803,757585,-782
2023,3,3110915,203117,177472,25645
2023,3,3110913,859116,823410,35706
2023,3,3110912,149116,161702,-12586
2023,3,3110910,451466,380487,70979
2023,3,3110908,21503,22229,-726
2023,3,3110907,809706,962160,-152454
2023,3,3110906,468291,476551,-8260
2023,3,3110905,368849,419271,-50422
2023,3,3110904,289250,251832,37418
2023,3,3110903,821181,798758,22423
2023,3,3110902,2391282,2329263,62019
2023,3,3110901,1166659,1189527,-22868
2023,3,3110900,1783385,1862998,-79613
2023,3,3110899,884928,938660,-53732
2023,3,3110897,1486439,1531192,-44753
2023,3,3110896,186229,194526,-8297
2023,3,3110895,3788093,3738440,49653
2023,3,3110893,85402,79713,5689
2023,3,3110892,4482825,4624832,-142007
2023,3,3110891,198151,181532,16619
2023,3,3110890,857695,831615,26080
2023,3,3110889,484186,501568,-17382
2023,3,3110888,823187,698350,124837
2023,3,3110887,507813,530499,-22686
2023,3,3110886,1179649,1108675,70974
2023,3,3110885,1397712,1419285,-21573
2023,3,3110884,875652,766202,109450
2023,3,3110883,1342973,1111647,231326
2023,3,3110882,1654011,1619239,34772
2023,3,3110881,4686015,4216516,469499
2023,3,3110880,528961,488719,40242
2023,3,3110879,301596,288845,12751
2023,3,3110878,609549,700447,-90898
2023,3,3110877,1253840,1329472,-75632
2023,3,3110876,511064,516442,-5378
2023,3,3110875,156525,160059,-3534
2023,3,3110874,1869412,1871445,-2033
2023,3,3110873,589493,612128,-22635
2023,3,3110872,884910,910440,-25530
2023,3,3110871,744726,755239,-10513
2023,3,3110869,4154377,4687025,-532648
2023,3,3110868,703026,703531,-505
2023,3,3110867,1255891,1232976,22915
2023,3,3110866,1182036,1245601,-63565
2023,3,3110865,2229780,2322667,-92887
2023,3,3110864,1470077,1714111,-244034
2023,3,3110863,797874,852848,-54974
2023,3,3110862,460543,575118,-114575
2023,3,3110861,1915236,2105677,-190441
2023,3,3110860,452758,485842,-33084
2023,3,3110859,546155,564412,-18257
2023,3,3110858,597401,488469,108932
2023,3,3110857,1115812,1106186,9626
2023,3,3110856,864793,870193,-5400
2023,3,3110855,1143860,1224477,-80617
2023,3,3110854,374884,434234,-59350
2023,3,3110853,1703944,1694014,9930
2023,3,3110852,581881,752410,-170529
2023,3,3110851,1101633,1116445,-14812
2023,3,3110850,2477810,2472337,5473
2023,3,3110849,1935894,1962040,-26146
2023,3,3110848,1263898,1370984,-107086
2023,3,3110847,776203,832683,-56480
2023,3,3110846,2670381,2542904,127477
2023,3,3110845,393352,396889,-3537
2023,3,3110843,477821,468186,9635
2023,3,3110842,168347,167586,761
2023,3,3110841,598416,1342257,-743841
2023,3,3110840,1173370,974151,199219
2023,3,3110839,808513,718762,89751
2023,3,3110838,127081,140204,-13123
2023,3,3110837,1668331,1762180,-93849
2023,3,3110836,1358479,1467268,-108789
2023,3,3110835,171380,170783,597
2023,3,3110833,559339,613505,-54166
2023,3,3110832,583175,586121,-2946
2023,3,3110831,557360,540360,17000
2023,3,3110830,555864,568068,-12204
2023,3,3110829,735274,753397,-18123
2023,3,3110828,1804449,1828882,-24433
2023,3,3110827,589645,432878,156767
2023,3,3110826,551702,826579,-274877
2023,3,3110825,2191888,2075120,116768
2023,3,3110824,226532,195315,31217
2023,3,3110823,749900,743899,6001
2023,3,3110822,689867,567170,122697
2023,3,3110821,1439177,1333879,105298
2023,3,3110820,844568,838961,5607
2023,3,3110819,987769,854092,133677
2023,3,3110818,335204,157849,177355
2023,3,3110817,360293,345412,14881
2023,3,3110816,843150,839329,3821
2023,3,3110815,1172883,1458651,-285768
2023,3,3110814,1278426,1332780,-54354
2023,3,3110813,1385940,1213483,172457
2023,3,3110812,584530,604784,-20254
2023,3,3110811,578440,471633,106807
2023,3,3110810,1542844,1540111,2733
2023,3,3110809,450730,449168,1562
2023,3,3110807,478898,469671,9227
2023,3,3110805,317861,323198,-5337
2023,3,3110804,939754,835928,103826
2023,3,3110803,1312129,1345184,-33055
2023,3,3110802,547585,581986,-34401
2023,3,3110800,162418,151049,11369
2023,3,3110799,161340,176884,-15544
2023,3,3110798,128149,134932,-6783
2023,3,3110796,113687,107049,6638
2023,3,3110795,1100429,1090429,10000
2023,3,3110794,992451,837120,155331
2023,3,3110792,1995313,2114712,-119399
2023,3,3110791,117583,127018,-9435
2023,3,3110790,652255,733114,-80859
2023,3,3110789,607734,585198,22536
2023,3,3110788,101113,83044,18069
2023,3,3110787,1592676,1295486,297190
2023,3,3110786,466187,414607,51580
2023,3,3110785,1213988,1087511,126477
2023,3,3110784,182944,198371,-15427
2023,3,3110783,262371,245634,16737
2023,3,3110782,217320,188545,28775
2023,3,3110781,1231224,1312273,-81049
2023,3,3110780,379311,338065,41246
2023,3,3110778,1273825,1267292,6533
2023,3,3110777,291508,264467,27041
2023,3,3110776,796044,810337,-14293
2023,3,3110775,290383,314028,-23645
2023,3,3110774,537634,433953,103681
2023,3,3110772,304748,307525,-2777
2023,3,3110771,430965,430844,121
2023,3,3110770,879177,653686,225491
2023,3,3110769,648482,552864,95618
2023,3,3110768,260240,242815,17425
2023,3,3110767,231006,256501,-25495
2023,3,3110766,1238403,1201201,37202
2023,3,3110765,346338,295713,50625
2023,3,3110762,1687823,1785984,-98161
2023,3,3110760,789250,783498,5752
2023,3,3110758,313664,339286,-25622
2023,3,3110757,232737,204574,28163
2023,3,3110756,274870,211326,63544
2023,3,3110755,250284,257937,-7653
2023,3,3110754,1411165,1488640,-77475
2023,3,3110753,997398,956666,40732
2023,3,3110752,745779,766550,-20771
2023,3,3110751,1036837,999490,37347
2023,3,3110750,740480,880622,-140142
2023,3,3110749,575035,588226,-13191
2023,3,3110748,413193,351975,61218
2023,3,3110747,153562,153790,-228
2023,3,3110746,199807,205296,-5489
2023,3,3110745,431334,422872,8462
2023,3,3110744,1770355,1612354,158001
2023,3,3110743,794133,899442,-105309
2023,3,3110742,72253,68803,3450
2023,3,3110741,468880,610539,-141659
2023,3,3110740,1712753,1484080,228673
2023,3,3110739,27838,29958,-2120
2023,3,3110738,763688,859673,-95985
2023,3,3110737,695319,1472167,-776848
2023,3,3110736,879264,831861,47403
2023,3,3110735,972941,1048641,-75700
2023,3,3110734,41664,25600,16064
2023,3,3110733,280841,251837,29004
2023,3,3110732,443223,381154,62069
2023,3,3110731,375747,414066,-38319
2023,3,3110730,547885,544881,3004
2023,3,3110729,648940,609462,39478
2023,3,3110728,175707,173322,2385
2023,3,3110727,449297,384755,64542
2023,3,3110726,295362,416306,-120944
2023,3,3110725,175053,206691,-31638
2023,3,3110724,584701,607832,-23131
2023,3,3110723,310053,306601,3452
2023,3,3110722,342213,345798,-3585
2023,3,3110721,1140345,1153878,-13533
2023,3,3110720,903797,1060381,-156584
2023,3,3110719,294228,311069,-16841
2023,3,3110718,976728,953026,23702
2023,3,3110717,2874214,2987451,-113237
2023,3,3110716,445955,394396,51559
2023,3,3110715,296399,284809,11590
2023,3,3110714,1419117,1518693,-99576
2023,3,3110713,2912694,2864600,48094
2023,3,3110712,2843546,2148269,695277
2023,3,3110711,1307430,1296862,10568
2023,3,3110710,2334568,2365608,-31040
2023,3,3110709,1270346,1263048,7298
2023,3,3110708,178514,371310,-192796
2023,3,3110707,1071260,1050288,20972
2023,3,3110706,258831,282289,-23458
2023,3,3110703,632348,588456,43892
2023,3,3110702,820009,941224,-121215
2023,3,3110701,657625,675381,-17756
2023,3,3110700,1120925,1005523,115402
2023,3,3110699,458187,496469,-38282
2023,3,3110698,709758,692760,16998
2023,3,3110697,488489,511491,-23002
2023,3,3110696,901104,582387,318717
2023,3,3110695,1462948,1612448,-149500
2023,3,3110694,1904222,1825222,79000
2023,3,3110693,152537,97134,55403
2023,3,3110692,731011,1001387,-270376
2023,3,3110691,701612,693652,7960
2023,3,3110690,1632346,1883607,-251261
2023,3,3110689,1089263,638595,450668
2023,3,3110688,739888,936804,-196916
2023,3,3110687,50542,53982,-3440
2023,3,3110686,772003,745001,27002
2023,3,3110684,69558,62474,7084
2023,3,3110683,258400,271343,-12943
2023,3,3110681,25385,28076,-2691
2023,3,3110680,211243,213793,-2550
2023,3,3110679,214615,221071,-6456
2023,3,3110678,152786,202233,-49447
2023,3,3110677,200313,181505,18808
2023,3,3110676,443228,406614,36614
2023,3,3110675,1890273,1644027,246246
2023,3,3110673,832911,647988,184923
2023,3,3110672,721244,699004,22240
2023,3,3110671,1937641,1999310,-61669
2023,3,3110670,1037834,1570982,-533148
2023,3,3110668,1577633,1671755,-94122
2023,3,3110666,224846,207701,17145
2023,3,3110665,2082574,1497922,584652
2023,3,3110664,248520,238941,9579
2023,3,3110663,220399,257221,-36822
2023,3,3110662,1886631,2513205,-626574
2023,3,3110661,319683,300706,18977
2023,3,3110660,774233,715005,59228
2023,3,3110659,4849288,4834573,14715
2023,3,3110658,755044,765053,-10009
2023,3,3110657,736949,618913,118036
2023,3,3110656,5466260,6254408,-788148
2023,3,3110655,310871,337252,-26381
2023,3,3110654,2836013,2365983,470030
2023,3,3110653,1139846,887461,252385
2023,3,3110652,326957,306993,19964
2023,3,3110651,445128,531615,-86487
2023,3,3110650,68778,70004,-1226
2023,3,3110649,1034450,966819,67631
2023,3,3110647,2339534,2627274,-287740
2023,3,3110646,1621594,1707365,-85771
2023,3,3110645,1307214,1307265,-51
2023,3,3110644,81456,90571,-9115
2023,3,3110643,557715,577573,-19858
2023,3,3110641,425578,254834,170744
2023,3,3110640,572653,602532,-29879
2023,3,3110639,528402,618543,-90141
2023,3,3110638,2011606,2179084,-167478
2023,3,3110637,217303,184785,32518
2023,3,3110636,629566,610484,19082
2023,3,3110635,252013,205806,46207
2023,3,3110634,1990184,2080156,-89972
2023,3,3110633,51101,52602,-1501
2023,3,3110632,677300,650000,27300
2023,3,3110631,652644,641278,11366
2023,3,3110630,1558441,1778158,-219717
2023,3,3110629,158419,145076,13343
2023,3,3110628,296821,259445,37376
2023,3,3110627,1426422,1250151,176271
2023,3,3110626,1416147,1528616,-112469
2023,3,3110625,865753,863618,2135
2023,3,3110624,476368,476142,226
2023,3,3110622,496741,461207,35534
2023,3,3110621,186641,221703,-35062
2023,3,3110620,2021418,2184377,-162959
2023,3,3110619,343743,329178,14565
2023,3,3110618,1576680,1625553,-48873
2023,3,3110617,513518,373485,140033
2023,3,3110616,246657,269438,-22781
2023,3,3110615,278809,236985,41824
2023,3,3110614,411409,384888,26521
2023,3,3110613,221408,226188,-4780
2023,3,3110612,2043784,2088627,-44843
2023,3,3110611,1188244,1157096,31148
2023,3,3110609,945552,960700,-15148
2023,3,3110608,1141530,1434369,-292839
2023,3,3110607,178078,154592,23486
2023,3,3110606,1424503,1406525,17978
2023,3,3110605,60573,47842,12731
2023,3,3110604,1006050,1105328,-99278
2023,3,3110603,89484,83913,5571
2023,3,3110602,178227,205437,-27210
2023,3,3110601,1470442,1394302,76140
2023,3,3110600,447846,401219,46627
2023,3,3110599,914698,1028155,-113457
2023,3,3110598,551443,605340,-53897
2023,3,3110597,1142555,1133943,8612
2023,3,3110596,591478,622830,-31352
2023,3,3110595,614130,591322,22808
2023,3,3110594,350219,316780,33439
2023,3,3110593,1027580,1061326,-33746
2023,3,3110592,242931,245789,-2858
2023,3,3110591,1002507,1312924,-310417
2023,3,3110590,1587038,1611218,-24180
2023,3,3110589,144947,118681,26266
2023,3,3110588,994133,1052362,-58229
2023,3,3110587,640027,674965,-34938
2023,3,3110586,1671369,1802592,-131223
2023,3,3110585,113254,118955,-5701
2023,3,3110584,90213,101921,-11708
2023,3,3110583,388559,396135,-7576
2023,3,3110582,488084,491026,-2942
2023,3,3110580,864433,729156,135277
2023,3,3110579,355288,321474,33814
2023,3,3110578,2455231,1685088,770143
2023,3,3110577,537098,618941,-81843
2023,3,3110576,1209737,1219248,-9511
2023,3,3110575,1064021,1080384,-16363
2023,3,3110574,53797,49918,3879
2023,3,3110573,105433,107740,-2307
2023,3,3110572,1878368,1823967,54401
2023,3,3110571,479618,494731,-15113
2023,3,3110570,207044,192771,14273
2023,3,3110569,801672,911551,-109879
2023,3,3110568,280698,284565,-3867
2023,3,3110567,272140,270768,1372
2023,3,3110566,1497507,1596789,-99282
2023,3,3110565,394957,420798,-25841
2023,3,3110564,919300,784971,134329
2023,3,3110563,202529,189713,12816
2023,3,3110562,1016449,975415,41034
2023,3,3110561,724811,802231,-77420
2023,3,3110560,987607,1048241,-60634
2023,3,3110559,910419,910507,-88
2023,3,3110558,3026257,2710783,315474
2023,3,3110557,823978,847294,-23316
2023,3,3110555,269651,202958,66693
2023,3,3110554,951966,860226,91740
2023,3,3110553,974101,717056,257045
2023,3,3110552,585564,758256,-172692
2023,3,3110551,1082141,1354206,-272065
2023,3,3110550,1797495,1731190,66305
2023,3,3110549,880543,1202806,-322263
2023,3,3110548,1237287,1200404,36883
2023,3,3110547,863958,816822,47136
2023,3,3110546,784730,779887,4843
2023,3,3110545,576062,532601,43461
2023,3,3110544,4708201,5172563,-464362
2023,3,3110543,126519,151630,-25111
2023,3,3110542,1410900,1487480,-76580
2023,3,3110541,1096882,1173294,-76412
2023,3,3110540,602815,578992,23823
2023,3,3110539,281670,277141,4529
2023,3,3110538,354350,372476,-18126
2023,3,3110537,462756,445490,17266
2023,3,3110536,129965,100223,29742
2023,3,3110535,990590,1107205,-116615
2023,3,3110534,547466,598110,-50644
2023,3,3110533,5230590,4678442,552148
2023,3,3110532,1059168,1078515,-19347
2023,3,3110529,1028640,1083543,-54903
2023,3,3110528,783458,861084,-77626
2023,3,3110527,445818,559405,-113587
2023,3,3110526,134550,137556,-3006
2023,3,3110525,380605,321498,59107
2023,3,3110524,148292,143696,4596
2023,3,3110523,70614,85871,-15257
2023,3,3110522,295976,217895,78081
2023,3,3110521,658624,632992,25632
2023,3,3110520,567396,597168,-29772
2023,3,3110519,1259176,1304265,-45089
2023,3,3110517,183638,162689,20949
2023,3,3110515,292529,411849,-119320
2023,3,3110514,690173,758529,-68356
2023,3,3110513,227963,254011,-26048
2023,3,3110512,698607,485640,212967
2023,3,3110511,878771,885766,-6995
2023,3,3110510,1068538,926944,141594
2023,3,3110509,804695,935987,-131292
2023,3,3110508,642313,481372,160941
2023,3,3110507,1640018,1662193,-22175
2023,3,3110506,200415,265414,-64999
2023,3,3110505,37664,62348,-24684
2023,3,3110503,1593054,1877456,-284402
2023,3,3110502,1681486,1347397,334089
2023,3,3110501,193330,172195,21135
2023,3,3110500,68121,22394,45727
2023,3,3110499,2217366,2527977,-310611
2023,3,3110498,1772449,1851668,-79219
2023,3,3110496,788976,896898,-107922
2023,3,3110495,1005938,958182,47756
2023,3,3110493,290311,418648,-128337
2023,3,3110491,62218,77801,-15583
2023,3,3110490,566909,561157,5752
2023,3,3110489,485858,424840,61018
2023,3,3110488,378238,470024,-91786
2023,3,3110487,136156,145153,-8997
2023,3,3110486,656516,588073,68443
2023,3,3110485,458754,501524,-42770
2023,3,3110484,1499630,1649222,-149592
2023,3,3110483,614060,664577,-50517
2023,3,3110482,358163,330391,27772
2023,3,3110481,3432912,2557376,875536
2023,3,3110480,254499,395621,-141122
2023,3,3110479,1158932,1074502,84430
2023,3,3110478,300506,382083,-81577
2023,3,3110477,388542,353789,34753
2023,3,3110476,136078,140829,-4751
2023,3,3110475,610099,706892,-96793
2023,3,3110474,905678,948039,-42361
2023,3,3110473,1783645,1784850,-1205
2023,3,3110472,1573945,1063636,510309
2023,3,3110471,1463740,1498840,-35100
2023,3,3110470,622242,641732,-19490
2023,3,3110469,1642116,1493864,148252
2023,3,3110468,3188055,3378017,-189962
2023,3,3110467,499061,686216,-187155
2023,3,3110466,1011840,987037,24803
2023,3,3110465,1420252,1643036,-222784
2023,3,3110464,456726,498430,-41704
2023,3,3110463,682708,646473,36235
2023,3,3110462,570715,899038,-328323
2023,3,3110461,247885,232665,15220
2023,3,3110460,1536131,1675276,-139145
2023,3,3110459,1059787,935810,123977
2023,3,3110458,958016,939483,18533
2023,3,3110457,714496,787406,-72910
2023,3,3110456,1547673,1604255,-56582
2023,3,3110455,1622663,1564717,57946
2023,3,3110454,1298152,1279441,18711
2023,3,3110453,1766614,1853133,-86519
2023,3,3110452,750621,719840,30781
2023,3,3110451,1062486,1160378,-97892
2023,3,3110450,1622868,1709927,-87059
2023,3,3110449,845969,896854,-50885
2023,3,3110448,413121,437045,-23924
2023,3,3110447,492245,505103,-12858
2023,3,3110446,124309,260751,-136442
2023,3,3110444,217851,217624,227
2023,3,3110443,139211,82775,56436
2023,3,3110442,120002,162881,-42879
2023,3,3110441,715220,636253,78967
2023,3,3110440,278893,356283,-77390
2023,3,3110439,1020308,1134089,-113781
2023,3,3110438,1491563,1494945,-3382
2023,3,3110437,1156349,1473599,-317250
2023,3,3110436,479510,504246,-24736
2023,3,3110435,96951,98194,-1243
2023,3,3110434,496393,483063,13330
2023,3,3110433,1330840,1339508,-8668
2023,3,3110432,430464,385894,44570
2023,3,3110431,494396,473806,20590
2023,3,3110429,2016679,2064719,-48040
2023,3,3110428,3490847,3907793,-416946
2023,3,3110427,104594,107350,-2756
2023,3,3110426,1589500,1724398,-134898
2023,3,3110425,805262,652896,152366
2023,3,3110424,2295760,2517801,-222041
2023,3,3110423,295368,301185,-5817
2023,3,3110422,859342,897345,-38003
2023,3,3110421,358767,340368,18399
2023,3,3110420,466627,529856,-63229
2023,3,3110419,843839,888918,-45079
2023,3,3110418,803360,666434,136926
2023,3,3110417,386805,406423,-19618
2023,3,3110416,903699,928068,-24369
2023,3,3110415,1970098,2003128,-33030
2023,3,3110413,94149,111566,-17417
2023,3,3110412,147592,161363,-13771
2023,3,3110411,559399,624567,-65168
2023,3,3110410,652390,705624,-53234
2023,3,3110409,565940,703492,-137552
2023,3,3110408,363175,403735,-40560
2023,3,3110407,1073247,987693,85554
2023,3,3110406,187401,182507,4894
2023,3,3110405,1426862,1476656,-49794
2023,3,3110404,3366641,3344573,22068
2023,3,3110403,1251342,1367029,-115687
2023,3,3110402,651683,720554,-68871
2023,3,3110401,158725,162482,-3757
2023,3,3110400,1278784,1307414,-28630
2023,3,3110399,1825425,1797624,27801
2023,3,3110398,867785,888246,-20461
2023,3,3110397,1465791,1668549,-202758
2023,3,3110396,900805,941403,-40598
2023,3,3110395,350158,309533,40625
2023,3,3110394,1108758,1138476,-29718
2023,3,3110393,41786,44023,-2237
2023,3,3110392,99160,146788,-47628
2023,3,3110391,486772,562070,-75298
2023,3,3110390,561669,612961,-51292
2023,3,3110389,384227,379827,4400
2023,3,3110388,775243,692849,82394
2023,3,3110387,1564115,1776473,-212358
2023,3,3110383,74722,74183,539
2023,3,3110382,554969,610589,-55620
2023,3,3110381,427676,434091,-6415
2023,3,3110380,651092,693429,-42337
2023,3,3110379,155702,154928,774
2023,3,3110378,740185,788077,-47892
2023,3,3110377,820219,758677,61542
2023,3,3110376,3058776,3242792,-184016
2023,3,3110375,650222,604636,45586
2023,3,3110374,2636939,2500667,136272
2023,3,3110373,1203307,1222938,-19631
2023,3,3110372,1566502,1680015,-113513
2023,3,3110371,681743,669382,12361
2023,3,3110370,1286821,1248446,38375
2023,3,3110369,1286508,1253758,32750
2023,3,3110368,2786724,2854251,-67527
2023,3,3110367,1211681,1490714,-279033
2023,3,3110366,541850,626537,-84687
2023,3,3110365,1846850,1769208,77642
2023,3,3110364,1535621,1559806,-24185
2023,3,3110363,233256,291051,-57795
2023,3,3110362,870644,857412,13232
2023,3,3110361,1227152,864053,363099
2023,3,3110360,1173885,1203524,-29639
2023,3,3110359,1563743,1018546,545197
2023,3,3110358,1032627,976991,55636
2023,3,3110357,993307,1045178,-51871
2023,3,3110356,888218,1155689,-267471
2023,3,3110355,1581862,1256884,324978
2023,3,3110354,73273,91990,-18717
2023,3,3110353,730214,641889,88325
2023,3,3110352,1645898,1695404,-49506
2023,3,3110351,579167,621261,-42094
2023,3,3110350,495141,530425,-35284
2023,3,3110349,571930,651349,-79419
2023,3,3110348,2026940,2190858,-163918
2023,3,3110346,1064885,716792,348093
2023,3,3110345,695118,693204,1914
2023,3,3110344,346987,336814,10173
2023,3,3110343,770814,889547,-118733
2023,3,3110342,1042471,1023222,19249
2023,3,3110341,227699,237999,-10300
2023,3,3110340,342859,357331,-14472
2023,3,3110337,421121,483800,-62679
2023,3,3110336,358919,340825,18094
2023,3,3110335,1276736,1305208,-28472
2023,3,3110334,2035939,2269036,-233097
2023,3,3110333,666809,659459,7350
2023,3,3110332,287965,290038,-2073
2023,3,3110331,1098032,1148330,-50298
2023,3,3110330,854494,864860,-10366
2023,3,3110329,601168,503112,98056
2023,3,3110328,1042437,1052535,-10098
2023,3,3110327,960612,963724,-3112
2023,3,3110326,462614,462638,-24
2023,3,3110325,1046918,1035431,11487
2023,3,3110323,1314315,1492820,-178505
2023,3,3110322,760866,760135,731
2023,3,3110320,184381,187633,-3252
2023,3,3110319,1283207,1143351,139856
2023,3,3110318,1213690,1202140,11550
2023,3,3110317,672586,714022,-41436
2023,3,3110316,2934338,2970034,-35696
2023,3,3110315,1570523,1602448,-31925
2023,3,3110314,731125,756369,-25244
2023,3,3110313,1576710,1424912,151798
2023,3,3110312,454186,462148,-7962
2023,3,3110310,44800,36242,8558
2023,3,3110309,366862,360886,5976
2023,3,3110308,1014620,1061081,-46461
2023,3,3110307,723062,691708,31354
2023,3,3110306,202101,168982,33119
2023,3,3110305,2064064,1969556,94508
2023,3,3110304,982551,1018304,-35753
2023,3,3110303,1221176,1326326,-105150
2023,3,3110302,289648,269375,20273
2023,3,3110301,1597346,1615811,-18465
2023,3,3110300,2867799,2806297,61502
2023,3,3110299,1823984,1859953,-35969
2023,3,3110298,290160,338006,-47846
2023,3,3110297,2306841,2377364,-70523
2023,3,3110296,871551,965140,-93589
2023,3,3110295,940062,923533,16529
2023,3,3110294,1528523,1512121,16402
2023,3,3110293,1490527,1430329,60198
2023,3,3110292,308554,314195,-5641
2023,3,3110291,2127235,2092902,34333
2023,3,3110290,199379,203724,-4345
2023,3,3110289,1339661,1406217,-66556
2023,3,3110288,249620,312232,-62612
2023,3,3110287,209117,225811,-16694
2023,3,3110286,791055,679421,111634
2023,3,3110285,148930,133970,14960
2023,3,3110284,96309,87579,8730
2023,3,3110283,136440,149022,-12582
2023,3,3110282,35492,39352,-3860
2023,3,3110281,68797,74213,-5416
2023,3,3110280,282962,257437,25525
2023,3,3110278,843337,781008,62329
2023,3,3110277,863076,969658,-106582
2023,3,3110276,45807,46991,-1184
2023,3,3110275,511833,564116,-52283
2023,3,3110274,1233128,1211142,21986
2023,3,3110273,669611,837428,-167817
2023,3,3110272,1318941,1280832,38109
2023,3,3110271,44779,48782,-4003
2023,3,3110270,303626,365850,-62224
2023,3,3110269,471774,457825,13949
2023,3,3110268,556590,557985,-1395
2023,3,3110267,1237663,1308319,-70656
2023,3,3110266,1565148,1570695,-5547
2023,3,3110265,465597,518969,-53372
2023,3,3110264,2896039,2948520,-52481
2023,3,3110263,1313302,1357414,-44112
2023,3,3110262,1899162,1898644,518
2023,3,3110261,1470513,1510786,-40273
2023,3,3110260,1338223,1523215,-184992
2023,3,3110259,1560967,1597119,-36152
2023,3,3110258,761122,735947,25175
2023,3,3110257,2103962,1770773,333189
2023,3,3110256,1592537,1667575,-75038
2023,3,3110255,2203888,1974284,229604
2023,3,3110254,3127180,3521219,-394039
2023,3,3110253,854479,797356,57123
2023,3,3110252,1018058,1000529,17529
2023,3,3110251,631234,741497,-110263
2023,3,3110250,478964,470566,8398
2023,3,3110249,1744582,2147386,-402804
2023,3,3110248,561277,575011,-13734
2023,3,3110247,2217978,2232520,-14542
2023,3,3110246,1387672,1423135,-35463
2023,3,3110245,555655,547368,8287
2023,3,3110244,1131068,852268,278800
2023,3,3110243,628252,754636,-126384
2023,3,3110242,508992,512819,-3827
2023,3,3110241,1071262,1003175,68087
2023,3,3110240,668438,695548,-27110
2023,3,3110238,75026,91782,-16756
2023,3,3110237,973694,966375,7319
2023,3,3110236,1877440,1982803,-105363
2023,3,3110234,322635,310865,11770
2023,3,3110233,1243011,1210516,32495
2023,3,3110232,813794,822770,-8976
2023,3,3110230,1069346,1052987,16359
2023,3,3110229,1826349,1822312,4037
2023,3,3110228,1637785,1544224,93561
2023,3,3110227,509980,556963,-46983
2023,3,3110226,2718659,2593736,124923
2023,3,3110225,196238,288583,-92345
2023,3,3110224,545805,640197,-94392
2023,3,3110221,258840,273342,-14502
2023,3,3110220,1118133,1178314,-60181
2023,3,3110219,1505985,1610867,-104882
2023,3,3110218,1239497,1319714,-80217
2023,3,3110217,623567,620720,2847
2023,3,3110216,357906,317931,39975
2023,3,3110215,730646,735047,-4401
2023,3,3110214,1489081,1489881,-800
2023,3,3110213,485499,530402,-44903
2023,3,3110212,955160,1069362,-114202
2023,3,3110211,2176429,2220205,-43776
2023,3,3110210,2415408,2234298,181110
2023,3,3110209,323841,329392,-5551
2023,3,3110208,342503,390613,-48110
2023,3,3110207,454147,539592,-85445
2023,3,3110206,1193067,1462601,-269534
2023,3,3110205,1981099,2161057,-179958
2023,3,3110204,1230539,1359950,-129411
2023,3,3110203,931468,465537,465931
2023,3,3110201,131486,134806,-3320
2023,3,3110200,377101,430244,-53143
2023,3,3110199,246517,318676,-72159
2023,3,3110197,261190,284400,-23210
2023,3,3110195,1532923,1546108,-13185
2023,3,3110194,334087,344881,-10794
2023,3,3110193,794090,834726,-40636
2023,3,3110191,1673661,1655401,18260
2023,3,3110190,935552,1115548,-179996
2023,3,3110189,942229,973081,-30852
2023,3,3110188,790591,840688,-50097
2023,3,3110187,2698386,2579362,119024
2023,3,3110186,144787,150522,-5735
2023,3,3110185,675496,644433,31063
2023,3,3110184,315060,272768,42292
2023,3,3110183,619180,576039,43141
2023,3,3110182,974275,801452,172823
2023,3,3110181,1313851,1418766,-104915
2023,3,3110180,228954,242553,-13599
2023,3,3110179,417895,510025,-92130
2023,3,3110178,313883,320623,-6740
2023,3,3110177,117066,98800,18266
2023,3,3110176,1194918,1291204,-96286
2023,3,3110175,988165,1134570,-146405
2023,3,3110174,796895,840129,-43234
2023,3,3110173,339780,385921,-46141
2023,3,3110172,930741,924953,5788
2023,3,3110171,338666,336864,1802
2023,3,3110170,2285549,2946578,-661029
2023,3,3110169,516767,618007,-101240
2023,3,3110168,429977,459691,-29714
2023,3,3110167,1693695,1735597,-41902
2023,3,3110166,1740192,1985592,-245400
2023,3,3110165,776250,715069,61181
2023,3,3110164,434564,451569,-17005
2023,3,3110163,564857,619471,-54614
2023,3,3110162,433508,487037,-53529
2023,3,3110161,662577,976182,-313605
2023,3,3110160,499990,508287,-8297
2023,3,3110159,3551308,3472753,78555
2023,3,3110158,2793061,2598728,194333
2023,3,3110157,1490239,1415326,74913
2023,3,3110156,911750,1088547,-176797
2023,3,3110155,957692,872103,85589
2023,3,3110154,1610732,1824539,-213807
2023,3,3110153,307416,294592,12824
2023,3,3110152,264726,261142,3584
2023,3,3110151,1325624,1334458,-8834
2023,3,3110150,1880301,1837886,42415
2023,3,3110149,205075,235819,-30744
2023,3,3110148,673592,573212,100380
2023,3,3110147,917606,908007,9599
2023,3,3110146,1376086,1688576,-312490
2023,3,3110144,380635,398928,-18293
2023,3,3110142,1964385,1958683,5702
2023,3,3110141,1861092,1799407,61685
2023,3,3110140,2530684,2242428,288256
2023,3,3110139,2122395,2132681,-10286
2023,3,3110138,973509,1294232,-320723
2023,3,3110137,1485615,1502012,-16397
2023,3,3110136,1106302,1229845,-123543
2023,3,3110135,285908,217191,68717
2023,3,3110134,1423013,1438036,-15023
2023,3,3110133,406255,354308,51947
2023,3,3110132,486949,501262,-14313
2023,3,3110131,824579,776493,48086
2023,3,3110130,599537,477697,121840
2023,3,3110129,194909,190961,3948
2023,3,3110128,1281708,1296017,-14309
2023,3,3110127,157495,141592,15903
2023,3,3110126,303543,380754,-77211
2023,3,3110125,913627,974865,-61238
2023,3,3110124,203092,254128,-51036
2023,3,3110123,868941,785097,83844
2023,3,3110122,322625,289719,32906
2023,3,3110121,218168,146503,71665
2023,3,3110120,342276,682178,-339902
2023,3,3110118,1130699,826013,304686
2023,3,3110117,448670,494016,-45346
2023,3,3110116,602127,622599,-20472
2023,3,3110115,713401,758357,-44956
2023,3,3110114,402236,402902,-666
2023,3,3110113,156166,160595,-4429
2023,3,3110112,779887,846976,-67089
2023,3,3110110,999282,1000587,-1305
2023,3,3110109,314520,323001,-8481
2023,3,3110107,70234,63723,6511
2023,3,3110105,790796,864920,-74124
2023,3,3110104,1212951,1253646,-40695
2023,3,3110103,298467,332034,-33567
2023,3,3110102,492715,536319,-43604
2023,3,3110099,233616,280581,-46965
2023,3,3110098,87287,86941,346
2023,3,3110096,233226,258500,-25274
2023,3,3110095,473992,486656,-12664
2023,3,3110093,2423867,2527428,-103561
2023,3,3110092,785573,726036,59537
2023,3,3110090,609971,595771,14200
2023,3,3110089,474539,507620,-33081
2023,3,3110088,386445,385743,702
2023,3,3110087,217285,274606,-57321
2023,3,3110085,1286160,1329965,-43805
2023,3,3110084,963546,917876,45670
2023,3,3110083,98754,92603,6151
2023,3,3110082,367347,388194,-20847
2023,3,3110081,1654677,1799335,-144658
2023,3,3110080,1690562,1428250,262312
2023,3,3110079,1959872,2114982,-155110
2023,3,3110078,86144,114624,-28480
2023,3,3110077,523323,549862,-26539
2023,3,3110075,879599,858072,21527
2023,3,3110074,747111,763999,-16888
2023,3,3110073,242459,227258,15201
2023,3,3110071,49582,39110,10472
2023,3,3110070,54085,50046,4039
2023,3,3110069,2108215,2307919,-199704
2023,3,3110068,1699305,1711656,-12351
2023,3,3110067,2141481,2410296,-268815
2023,3,3110066,1524865,1331423,193442
2023,3,3110065,62417,56571,5846
2023,3,3110064,1273119,1361953,-88834
2023,3,3110063,872284,840535,31749
2023,3,3110062,816371,819334,-2963
2023,3,3110061,1243465,1260958,-17493
2023,3,3110060,704569,611202,93367
2023,3,3110059,565383,898301,-332918
2023,3,3110058,1640931,1523504,117427
2023,3,3110057,766352,787721,-21369
2023,3,3110056,1564547,1957431,-392884
2023,3,3110055,489568,506131,-16563
2023,3,3110054,1043509,960623,82886
2023,3,3110053,1110433,1061457,48976
2023,3,3110052,620193,579479,40714
2023,3,3110051,950458,911490,38968
2023,3,3110050,449312,414370,34942
2023,3,3110049,630665,687604,-56939
2023,3,3110048,920316,821941,98375
2023,3,3110047,586191,598269,-12078
2023,3,3110045,663842,701270,-37428
2023,3,3110043,757621,737285,20336
2023,3,3110042,181322,183182,-1860
2023,3,3110041,308603,310764,-2161
2023,3,3110040,162045,172911,-10866
2023,3,3110039,85879,88190,-2311
2023,3,3110037,819565,870104,-50539
2023,3,3110036,332219,377077,-44858
2023,3,3110035,1352717,1323092,29625
2023,3,3110033,648123,685461,-37338
2023,3,3110031,63253,61202,2051
2023,3,3110030,145499,142789,2710
2023,3,3110029,3086336,3277640,-191304
2023,3,3110028,2359706,2623938,-264232
2023,3,3110027,385582,385225,357
2023,3,3110025,380861,241228,139633
2023,3,3110024,258133,323937,-65804
2023,3,3110023,405741,374669,31072
2023,3,3110022,533908,559847,-25939
2023,3,3110021,1276719,1399295,-122576
2023,3,3110020,1788799,1915828,-127029
2023,3,3110018,449745,468901,-19156
2023,3,3110017,449300,459804,-10504
2023,3,3110016,36182,35266,916
2023,3,3110014,57976,55984,1992
2023,3,3110012,606444,616940,-10496
2023,3,3110010,122420,171884,-49464
2023,3,3110009,162009,172025,-10016
2023,3,3110008,1251380,1285556,-34176
2023,3,3110007,906104,876340,29764
2023,3,3110006,7335,6894,441
2023,3,3110005,110053,121114,-11061
2023,3,3110004,642932,545454,97478
2023,3,3110003,552786,634516,-81730
2023,3,3110002,547929,577170,-29241
2023,3,3110001,126315,152037,-25722
2023,2,3111089,852368,831137,21231
2023,2,3111088,315716,320910,-5194
2023,2,3111087,208259,219530,-11271
2023,2,3111086,449561,380220,69341
2023,2,3111085,849672,840202,9470
2023,2,3111084,188109,192701,-4592
2023,2,3111083,801824,971791,-169967
2023,2,3111082,136034,140941,-4907
2023,2,3111080,607012,563666,43346
2023,2,3111079,377104,361052,16052
2023,2,3111078,3978001,4062309,-84308
2023,2,3111077,3269054,3297767,-28713
2023,2,3111076,384147,437598,-53451
2023,2,3111075,1398031,1500523,-102492
2023,2,3111074,578799,617550,-38751
2023,2,3111073,3640304,3591131,49173
2023,2,3111072,1821612,2230206,-408594
2023,2,3111071,620248,530411,89837
2023,2,3111070,1364570,1504200,-139630
2023,2,3111069,2475180,2656436,-181256
2023,2,3111068,254462,251235,3227
2023,2,3111067,2543374,2571669,-28295
2023,2,3111066,1306910,1235481,71429
2023,2,3111065,552892,587982,-35090
2023,2,3111064,483664,525387,-41723
2023,2,3111063,1362650,1404886,-42236
2023,2,3111062,932483,899495,32988
2023,2,3111061,2602756,3054434,-451678
2023,2,3111060,3232652,3540886,-308234
2023,2,3111059,3129557,3393472,-263915
2023,2,3111058,498863,471160,27703
2023,2,3111057,926923,931072,-4149
2023,2,3111056,354390,347383,7007
2023,2,3111055,30715,27985,2730
2023,2,3111054,201805,199988,1817
2023,2,3111053,1164924,1136170,28754
2023,2,3111052,1341314,1260286,81028
2023,2,3111051,2810433,2893405,-82972
2023,2,3111049,1279354,1287310,-7956
2023,2,3111047,264262,270806,-6544
2023,2,3111046,1943075,2058625,-115550
2023,2,3111045,283912,273959,9953
2023,2,3111044,1279372,1441632,-162260
2023,2,3111043,647317,712179,-64862
2023,2,3111042,2014943,1905547,109396
2023,2,3111040,785482,618512,166970
2023,2,3111039,1021735,990736,30999
2023,2,3111038,625594,444259,181335
2023,2,3111037,257934,245904,12030
2023,2,3111036,347280,354867,-7587
2023,2,3111035,622859,823489,-200630
2023,2,3111034,845829,847409,-1580
2023,2,3111033,44476,48506,-4030
2023,2,3111032,503592,375313,128279
2023,2,3111031,987941,971361,16580
2023,2,3111030,1352444,1413573,-61129
2023,2,3111029,193213,186845,6368
2023,2,3111028,854112,940076,-85964
2023,2,3111027,920084,919793,291
2023,2,3111026,935481,935778,-297
2023,2,3111025,922986,789347,133639
2023,2,3111024,357953,434512,-76559
2023,2,3111023,855036,875867,-20831
2023,2,3111022,387445,372741,14704
2023,2,3111021,2264111,2349518,-85407
2023,2,3111020,243238,233585,9653
2023,2,3111019,1441585,1480512,-38927
2023,2,3111017,161603,190138,-28535
2023,2,3111016,705726,747031,-41305
2023,2,3111015,1729079,2034909,-305830
2023,2,3111014,762560,739036,23524
2023,2,3111013,2385680,2457091,-71411
2023,2,3111012,939405,1034498,-95093
2023,2,3111011,41279,36933,4346
2023,2,3111010,1634384,1865758,-231374
2023,2,3111009,238882,241411,-2529
2023,2,3111008,643690,744972,-101282
2023,2,3111007,1120087,1239377,-119290
2023,2,3111006,1983792,2336053,-352261
2023,2,3111005,1451381,1434984,16397
2023,2,3111004,2220141,2309320,-89179
2023,2,3111003,2125512,2075947,49565
2023,2,3111001,41261,51006,-9745
2023,2,3110999,162662,151319,11343
2023,2,3110997,1798358,2012571,-214213
2023,2,3110996,856557,744255,112302
2023,2,3110995,639910,592808,47102
2023,2,3110994,477300,485580,-8280
2023,2,3110992,1919307,1920712,-1405
2023,2,3110989,635078,690559,-55481
2023,2,3110988,132883,127337,5546
2023,2,3110984,879575,942177,-62602
2023,2,3110983,445953,459352,-13399
2023,2,3110982,351612,357951,-6339
2023,2,3110981,440765,426501,14264
2023,2,3110980,518300,538000,-19700
2023,2,3110979,320473,328543,-8070
2023,2,3110976,816615,742194,74421
2023,2,3110975,324039,320980,3059
2023,2,3110974,374463,445764,-71301
2023,2,3110973,1064595,1157676,-93081
2023,2,3110972,300241,353230,-52989
2023,2,3110971,766079,801351,-35272
2023,2,3110970,345026,352513,-7487
2023,2,3110969,870901,798395,72506
2023,2,3110968,286312,299532,-13220
2023,2,3110967,577113,724580,-147467
2023,2,3110966,1737383,1692375,45008
2023,2,3110961,1036621,916220,120401
2023,2,3110959,104503,60604,43899
2023,2,3110958,631876,624936,6940
2023,2,3110957,892731,910322,-17591
2023,2,3110956,543709,447761,95948
2023,2,3110955,2627304,2883664,-256360
2023,2,3110954,484847,461153,23694
2023,2,3110953,410970,440834,-29864
2023,2,3110952,211555,219900,-8345
2023,2,3110951,542830,598915,-56085
2023,2,3110949,363071,386687,-23616
2023,2,3110947,16311,40565,-24254
2023,2,3110945,30625,33414,-2789
2023,2,3110943,509724,496395,13329
2023,2,3110942,1665406,1782038,-116632
2023,2,3110940,402321,407419,-5098
2023,2,3110939,1950042,1988732,-38690
2023,2,3110936,201958,206232,-4274
2023,2,3110935,676232,643296,32936
2023,2,3110934,434562,428974,5588
2023,2,3110932,243387,239519,3868
2023,2,3110931,23381,24640,-1259
2023,2,3110930,468783,591557,-122774
2023,2,3110929,1621075,1546407,74668
2023,2,3110926,910428,1073432,-163004
2023,2,3110925,563745,617752,-54007
2023,2,3110924,423951,444902,-20951
2023,2,3110922,946379,838749,107630
2023,2,3110921,279612,421154,-141542
2023,2,3110919,598217,660942,-62725
2023,2,3110918,1067317,1051521,15796
2023,2,3110917,104475,110443,-5968
2023,2,3110916,730552,785595,-55043
2023,2,3110915,196967,184061,12906
2023,2,3110913,857722,859915,-2193
2023,2,3110912,153068,171517,-18449
2023,2,3110910,396497,362975,33522
2023,2,3110908,24748,22882,1866
2023,2,3110907,946698,887750,58948
2023,2,3110906,510904,559883,-48979
2023,2,3110905,389758,418929,-29171
2023,2,3110904,325103,261658,63445
2023,2,3110903,780686,826270,-45584
2023,2,3110902,2361213,2371751,-10538
2023,2,3110901,1198594,1183901,14693
2023,2,3110900,1805523,1917258,-111735
2023,2,3110899,875833,978066,-102233
2023,2,3110897,1494228,1506511,-12283
2023,2,3110896,191164,201277,-10113
2023,2,3110895,3797619,3936707,-139088
2023,2,3110893,92496,86944,5552
2023,2,3110892,4539008,4765615,-226607
2023,2,3110891,214433,147016,67417
2023,2,3110890,839686,851743,-12057
2023,2,3110889,465031,493061,-28030
2023,2,3110888,765765,726837,38928
2023,2,3110887,543328,523087,20241
2023,2,3110886,1137228,1137610,-382
2023,2,3110885,1417883,1461027,-43144
2023,2,3110884,725792,774529,-48737
2023,2,3110883,1370432,1159577,210855
2023,2,3110882,1673153,1656311,16842
2023,2,3110881,4775565,4391647,383918
2023,2,3110880,488917,493916,-4999
2023,2,3110879,301634,296407,5227
2023,2,3110878,617585,713230,-95645
2023,2,3110877,1291186,1352886,-61700
2023,2,3110876,515855,580655,-64800
2023,2,3110875,154610,173414,-18804
2023,2,3110874,1894285,1965060,-70775
2023,2,3110873,544847,661996,-117149
2023,2,3110872,882548,799463,83085
2023,2,3110871,769173,740563,28610
2023,2,3110869,4242644,4713491,-470847
2023,2,3110868,711403,731116,-19713
2023,2,3110867,1271223,1315631,-44408
2023,2,3110866,1218251,1272469,-54218
2023,2,3110865,2213523,2216555,-3032
2023,2,3110864,1517761,1782532,-264771
2023,2,3110863,786367,931871,-145504
2023,2,3110862,431572,740511,-308939
2023,2,3110861,1960232,2112716,-152484
2023,2,3110860,469072,486038,-16966
2023,2,3110859,519233,586431,-67198
2023,2,3110858,643715,502012,141703
2023,2,3110857,1102070,1110693,-8623
2023,2,3110856,872780,888439,-15659
2023,2,3110855,1056048,1317326,-261278
2023,2,3110854,391008,428616,-37608
2023,2,3110853,1796750,1770760,25990
2023,2,3110852,525919,778394,-252475
2023,2,3110851,1285236,1186040,99196
2023,2,3110850,2482012,2564820,-82808
2023,2,3110849,1988480,1867712,120768
2023,2,3110848,1201667,1448207,-246540
2023,2,3110847,798162,874741,-76579
2023,2,3110846,2681256,2819947,-138691
2023,2,3110845,354183,388186,-34003
2023,2,3110843,502268,489008,13260
2023,2,3110842,173460,165884,7576
2023,2,3110841,823505,1421098,-597593
2023,2,3110840,1312747,963766,348981
2023,2,3110839,906157,781231,124926
2023,2,3110838,131807,152362,-20555
2023,2,3110837,1762814,1900732,-137918
2023,2,3110836,1475681,1550973,-75292
2023,2,3110835,188835,162976,25859
2023,2,3110833,567844,598244,-30400
2023,2,3110832,586921,601311,-14390
2023,2,3110831,548527,531073,17454
2023,2,3110830,579534,593594,-14060
2023,2,3110829,776780,744866,31914
2023,2,3110828,1754951,1880340,-125389
2023,2,3110827,606943,569912,37031
2023,2,3110826,599286,725238,-125952
2023,2,3110825,2156899,2071345,85554
2023,2,3110824,222588,262863,-40275
2023,2,3110823,739997,694445,45552
2023,2,3110822,695214,568546,126668
2023,2,3110821,1423440,1399833,23607
2023,2,3110820,810941,872929,-61988
2023,2,3110819,960760,836282,124478
2023,2,3110818,354964,154028,200936
2023,2,3110817,374469,327969,46500
2023,2,3110816,872067,718193,153874
2023,2,3110815,1161360,1545950,-384590
2023,2,3110814,1240758,1388848,-148090
2023,2,3110813,1395278,1310206,85072
2023,2,3110812,591525,605664,-14139
2023,2,3110811,540442,436812,103630
2023,2,3110810,1511153,1644995,-133842
2023,2,3110809,430824,415346,15478
2023,2,3110807,487639,488405,-766
2023,2,3110805,320407,316542,3865
2023,2,3110804,932991,865956,67035
2023,2,3110803,1347145,1342814,4331
2023,2,3110802,534791,590315,-55524
2023,2,3110800,156845,156306,539
2023,2,3110799,164118,171676,-7558
2023,2,3110798,126339,133104,-6765
2023,2,3110796,113724,84563,29161
2023,2,3110795,1072204,1111326,-39122
2023,2,3110794,1005137,849832,155305
2023,2,3110792,1905141,2140773,-235632
2023,2,3110791,114540,115876,-1336
2023,2,3110790,637572,728247,-90675
2023,2,3110789,576091,567812,8279
2023,2,3110788,96122,83972,12150
2023,2,3110787,1547568,1287967,259601
2023,2,3110786,406149,422344,-16195
2023,2,3110785,1207730,1088925,118805
2023,2,3110784,177465,195942,-18477
2023,2,3110783,262533,232082,30451
2023,2,3110782,195818,184598,11220
2023,2,3110781,1228043,1340522,-112479
2023,2,3110780,362092,334757,27335
2023,2,3110778,1270418,1227777,42641
2023,2,3110777,305322,266202,39120
2023,2,3110776,801445,805026,-3581
2023,2,3110775,290729,309395,-18666
2023,2,3110774,500578,478308,22270
2023,2,3110772,297595,321287,-23692
2023,2,3110771,419541,423149,-3608
2023,2,3110770,864645,649556,215089
2023,2,3110769,630433,517724,112709
2023,2,3110768,248913,222173,26740
2023,2,3110767,229406,253570,-24164
2023,2,3110766,1255319,1230753,24566
2023,2,3110765,362131,325251,36880
2023,2,3110762,1699847,1837143,-137296
2023,2,3110760,790290,772011,18279
2023,2,3110758,330610,358095,-27485
2023,2,3110757,223528,205887,17641
2023,2,3110756,226744,215909,10835
2023,2,3110755,248992,266436,-17444
2023,2,3110754,1436087,1509782,-73695
2023,2,3110753,974238,1004669,-30431
2023,2,3110752,764819,781327,-16508
2023,2,3110751,1012103,1009017,3086
2023,2,3110750,733307,876889,-143582
2023,2,3110749,573002,608378,-35376
2023,2,3110748,390903,374387,16516
2023,2,3110747,159550,156529,3021
2023,2,3110746,193467,210408,-16941
2023,2,3110745,414327,417513,-3186
2023,2,3110744,1763848,1614892,148956
2023,2,3110743,769486,890975,-121489
2023,2,3110742,76342,70863,5479
2023,2,3110741,534086,626260,-92174
2023,2,3110740,1748198,1555593,192605
2023,2,3110739,28924,29944,-1020
2023,2,3110738,753600,888302,-134702
2023,2,3110737,1167644,1570345,-402701
2023,2,3110736,896497,813336,83161
2023,2,3110735,941003,1095627,-154624
2023,2,3110734,40902,22825,18077
2023,2,3110733,294958,238521,56437
2023,2,3110732,435488,359003,76485
2023,2,3110731,386382,445931,-59549
2023,2,3110730,578900,540242,38658
2023,2,3110729,666565,607517,59048
2023,2,3110728,189885,172975,16910
2023,2,3110727,403299,379026,24273
2023,2,3110726,281737,247945,33792
2023,2,3110725,188387,215475,-27088
2023,2,3110724,580960,618327,-37367
2023,2,3110723,310412,304226,6186
2023,2,3110722,328550,356030,-27480
2023,2,3110721,1101631,1125484,-23853
2023,2,3110720,920582,1053952,-133370
2023,2,3110719,301169,309623,-8454
2023,2,3110718,934752,969034,-34282
2023,2,3110717,2861506,3006486,-144980
2023,2,3110716,429394,410540,18854
2023,2,3110715,290406,295090,-4684
2023,2,3110714,1455674,1542419,-86745
2023,2,3110713,2775738,2826905,-51167
2023,2,3110712,2581237,2086279,494958
2023,2,3110711,1202351,1294880,-92529
2023,2,3110710,2322105,2357426,-35321
2023,2,3110709,1185513,1290144,-104631
2023,2,3110708,303069,353392,-50323
2023,2,3110707,1039872,1127802,-87930
2023,2,3110706,245815,294212,-48397
2023,2,3110703,637002,620683,16319
2023,2,3110702,806888,1085231,-278343
2023,2,3110701,656400,677330,-20930
2023,2,3110700,1039178,963625,75553
2023,2,3110699,457408,504396,-46988
2023,2,3110698,704730,713574,-8844
2023,2,3110697,480494,551799,-71305
2023,2,3110696,804714,594075,210639
2023,2,3110695,1535181,1610900,-75719
2023,2,3110694,1876836,1854474,22362
2023,2,3110693,157573,102904,54669
2023,2,3110692,794756,1014213,-219457
2023,2,3110691,683280,715768,-32488
2023,2,3110690,1777186,1923619,-146433
2023,2,3110689,1097176,662904,434272
2023,2,3110688,804910,970411,-165501
2023,2,3110687,61320,61932,-612
2023,2,3110686,906456,759932,146524
2023,2,3110684,75950,58476,17474
2023,2,3110683,274498,277253,-2755
2023,2,3110681,27672,29670,-1998
2023,2,3110680,218629,224010,-5381
2023,2,3110679,217471,249036,-31565
2023,2,3110678,148446,170586,-22140
2023,2,3110677,198503,183859,14644
2023,2,3110676,451476,452165,-689
2023,2,3110675,1542131,1681499,-139368
2023,2,3110673,783675,663905,119770
2023,2,3110672,739276,674317,64959
2023,2,3110671,1935949,2102388,-166439
2023,2,3110670,1484177,1556836,-72659
2023,2,3110668,1550071,1763670,-213599
2023,2,3110666,233943,203460,30483
2023,2,3110665,2030960,1133828,897132
2023,2,3110664,254594,238829,15765
2023,2,3110663,271815,257487,14328
2023,2,3110662,1894911,2535842,-640931
2023,2,3110661,312487,281993,30494
2023,2,3110660,799897,710602,89295
2023,2,3110659,4878700,4772045,106655
2023,2,3110658,779201,888647,-109446
2023,2,3110657,723859,714814,9045
2023,2,3110656,5723610,6044827,-321217
2023,2,3110655,324181,389554,-65373
2023,2,3110654,2655025,2390334,264691
2023,2,3110653,981414,970114,11300
2023,2,3110652,338458,312153,26305
2023,2,3110651,450974,544545,-93571
2023,2,3110650,73450,80790,-7340
2023,2,3110649,1005328,999740,5588
2023,2,3110647,2446283,2616813,-170530
2023,2,3110646,1634549,1764249,-129700
2023,2,3110645,1323193,1398176,-74983
2023,2,3110644,77957,93378,-15421
2023,2,3110643,556725,638693,-81968
2023,2,3110641,321924,242290,79634
2023,2,3110640,553438,601435,-47997
2023,2,3110639,568258,417918,150340
2023,2,3110638,2152005,2222969,-70964
2023,2,3110637,207527,197996,9531
2023,2,3110636,673638,635152,38486
2023,2,3110635,250784,272223,-21439
2023,2,3110634,1866695,2071195,-204500
2023,2,3110633,51936,55748,-3812
2023,2,3110632,702940,686000,16940
2023,2,3110631,616182,622572,-6390
2023,2,3110630,1610446,1785234,-174788
2023,2,3110629,143433,157835,-14402
2023,2,3110628,291815,267378,24437
2023,2,3110627,1520884,1355521,165363
2023,2,3110626,1432259,1477082,-44823
2023,2,3110625,863423,626564,236859
2023,2,3110624,477000,469052,7948
2023,2,3110622,504403,485286,19117
2023,2,3110621,178187,272288,-94101
2023,2,3110620,2020720,2192694,-171974
2023,2,3110619,325240,329508,-4268
2023,2,3110618,1683154,1553678,129476
2023,2,3110617,497814,514443,-16629
2023,2,3110616,252019,240829,11190
2023,2,3110615,294989,214763,80226
2023,2,3110614,403683,520281,-116598
2023,2,3110613,211559,235622,-24063
2023,2,3110612,2044628,2090632,-46004
2023,2,3110611,1209807,1150846,58961
2023,2,3110609,940183,979865,-39682
2023,2,3110608,1158501,1592395,-433894
2023,2,3110607,172613,157584,15029
2023,2,3110606,1410344,1433318,-22974
2023,2,3110605,52439,45722,6717
2023,2,3110604,976212,1126231,-150019
2023,2,3110603,89808,87511,2297
2023,2,3110602,184686,190044,-5358
2023,2,3110601,1427733,1400803,26930
2023,2,3110600,441436,561178,-119742
2023,2,3110599,887656,1096659,-209003
2023,2,3110598,561892,549782,12110
2023,2,3110597,1160090,1174712,-14622
2023,2,3110596,619847,632556,-12709
2023,2,3110595,620168,587366,32802
2023,2,3110594,364215,388785,-24570
2023,2,3110593,1005844,1094750,-88906
2023,2,3110592,242892,254006,-11114
2023,2,3110591,1189156,1518109,-328953
2023,2,3110590,1706415,1627584,78831
2023,2,3110589,142242,113929,28313
2023,2,3110588,1020526,1056743,-36217
2023,2,3110587,623485,854523,-231038
2023,2,3110586,1704487,1774788,-70301
2023,2,3110585,114325,136274,-21949
2023,2,3110584,92630,106215,-13585
2023,2,3110583,368675,385526,-16851
2023,2,3110582,519440,509836,9604
2023,2,3110580,746930,758290,-11360
2023,2,3110579,363759,319788,43971
2023,2,3110578,2586337,1396654,1189683
2023,2,3110577,509761,629158,-119397
2023,2,3110576,1299341,1216730,82611
2023,2,3110575,1101066,1116201,-15135
2023,2,3110574,63593,52859,10734
2023,2,3110573,115715,109092,6623
2023,2,3110572,1997050,1867004,130046
2023,2,3110571,474773,507927,-33154
2023,2,3110570,203324,213355,-10031
2023,2,3110569,853129,976741,-123612
2023,2,3110568,275974,299305,-23331
2023,2,3110567,271485,272243,-758
2023,2,3110566,1571149,1513826,57323
2023,2,3110565,441532,436307,5225
2023,2,3110564,941560,800590,140970
2023,2,3110563,173826,196574,-22748
2023,2,3110562,987677,1148487,-160810
2023,2,3110561,763460,822730,-59270
2023,2,3110560,976514,1090122,-113608
2023,2,3110559,917230,969033,-51803
2023,2,3110558,3055029,2513508,541521
2023,2,3110557,826192,891048,-64856
2023,2,3110555,229652,217010,12642
2023,2,3110554,981091,891234,89857
2023,2,3110553,945353,822910,122443
2023,2,3110552,581728,764147,-182419
2023,2,3110551,1214752,1435434,-220682
2023,2,3110550,1732047,1716437,15610
2023,2,3110549,881191,1231891,-350700
2023,2,3110548,1216423,1136253,80170
2023,2,3110547,901589,852187,49402
2023,2,3110546,688549,765802,-77253
2023,2,3110545,557341,531952,25389
2023,2,3110544,4603945,5182306,-578361
2023,2,3110543,144436,91900,52536
2023,2,3110542,1510727,1528303,-17576
2023,2,3110541,983421,1259218,-275797
2023,2,3110540,608787,568400,40387
2023,2,3110539,277973,285525,-7552
2023,2,3110538,372634,392984,-20350
2023,2,3110537,469707,449299,20408
2023,2,3110536,116140,106859,9281
2023,2,3110535,1042743,1127136,-84393
2023,2,3110534,578748,631660,-52912
2023,2,3110533,4935769,4571052,364717
2023,2,3110532,1065877,1089227,-23350
2023,2,3110529,1032728,1112873,-80145
2023,2,3110528,878302,940711,-62409
2023,2,3110527,441301,564677,-123376
2023,2,3110526,151467,144308,7159
2023,2,3110525,455388,332693,122695
2023,2,3110524,170300,142893,27407
2023,2,3110523,75926,107229,-31303
2023,2,3110522,238212,221332,16880
2023,2,3110521,593704,670848,-77144
2023,2,3110520,617847,599549,18298
2023,2,3110519,1314591,1150231,164360
2023,2,3110517,196714,179624,17090
2023,2,3110515,421008,370577,50431
2023,2,3110514,784234,746995,37239
2023,2,3110513,212600,359117,-146517
2023,2,3110512,514773,528931,-14158
2023,2,3110511,929738,912351,17387
2023,2,3110510,917423,969928,-52505
2023,2,3110509,810096,919274,-109178
2023,2,3110508,553602,493075,60527
2023,2,3110507,1750393,1614901,135492
2023,2,3110506,220090,270565,-50475
2023,2,3110505,46720,66275,-19555
2023,2,3110503,2013062,2051676,-38614
2023,2,3110502,1374808,1634737,-259929
2023,2,3110501,141109,257991,-116882
2023,2,3110500,30033,83490,-53457
2023,2,3110499,2208616,2457410,-248794
2023,2,3110498,1831293,1841299,-10006
2023,2,3110496,833788,997342,-163554
2023,2,3110495,1042438,1257388,-214950
2023,2,3110493,295771,419433,-123662
2023,2,3110491,56462,74731,-18269
2023,2,3110490,568553,581945,-13392
2023,2,3110489,413626,543770,-130144
2023,2,3110488,379593,484085,-104492
2023,2,3110487,140583,118521,22062
2023,2,3110486,600972,605539,-4567
2023,2,3110485,469060,549531,-80471
2023,2,3110484,1654004,1681850,-27846
2023,2,3110483,606112,682117,-76005
2023,2,3110482,342626,306508,36118
2023,2,3110481,3283797,2381277,902520
2023,2,3110480,290178,398303,-108125
2023,2,3110479,1054124,1169849,-115725
2023,2,3110478,304768,436641,-131873
2023,2,3110477,352492,357608,-5116
2023,2,3110476,137350,137318,32
2023,2,3110475,638474,693673,-55199
2023,2,3110474,917955,966974,-49019
2023,2,3110473,1729936,1805433,-75497
2023,2,3110472,1709701,1172253,537448
2023,2,3110471,1467780,1497994,-30214
2023,2,3110470,613880,622040,-8160
2023,2,3110469,1700244,1719972,-19728
2023,2,3110468,3184061,3436573,-252512
2023,2,3110467,547329,775772,-228443
2023,2,3110466,996062,1022825,-26763
2023,2,3110465,1422620,1606554,-183934
2023,2,3110464,460927,514370,-53443
2023,2,3110463,633831,583556,50275
2023,2,3110462,539774,974865,-435091
2023,2,3110461,237367,239085,-1718
2023,2,3110460,1593916,1698316,-104400
2023,2,3110459,913590,948508,-34918
2023,2,3110458,961608,965518,-3910
2023,2,3110457,800323,788183,12140
2023,2,3110456,1601123,1610092,-8969
2023,2,3110455,1541847,1584899,-43052
2023,2,3110454,1287568,1328664,-41096
2023,2,3110453,1757322,1864137,-106815
2023,2,3110452,714222,889518,-175296
2023,2,3110451,1098284,1359505,-261221
2023,2,3110450,1693076,1793938,-100862
2023,2,3110449,894798,924144,-29346
2023,2,3110448,432035,535008,-102973
2023,2,3110447,534968,519344,15624
2023,2,3110446,181373,319631,-138258
2023,2,3110444,245395,150980,94415
2023,2,3110443,78757,91178,-12421
2023,2,3110442,124407,171691,-47284
2023,2,3110441,667738,664242,3496
2023,2,3110440,308875,365543,-56668
2023,2,3110439,1064020,1152520,-88500
2023,2,3110438,1474454,1560064,-85610
2023,2,3110437,1378548,1517599,-139051
2023,2,3110436,489002,528399,-39397
2023,2,3110435,108089,106536,1553
2023,2,3110434,500865,482683,18182
2023,2,3110433,1357377,1391797,-34420
2023,2,3110432,444272,403215,41057
2023,2,3110431,497960,481078,16882
2023,2,3110429,2057046,2099211,-42165
2023,2,3110428,3589130,4049493,-460363
2023,2,3110427,103195,113859,-10664
2023,2,3110426,1633778,1763345,-129567
2023,2,3110425,658582,659497,-915
2023,2,3110424,2321178,2583444,-262266
2023,2,3110423,298386,316542,-18156
2023,2,3110422,865488,913501,-48013
2023,2,3110421,348527,372250,-23723
2023,2,3110420,499078,590141,-91063
2023,2,3110419,849024,869662,-20638
2023,2,3110418,927981,776354,151627
2023,2,3110417,417037,458627,-41590
2023,2,3110416,886210,938910,-52700
2023,2,3110415,1935472,2027181,-91709
2023,2,3110413,94252,111288,-17036
2023,2,3110412,148642,172111,-23469
2023,2,3110411,526985,686284,-159299
2023,2,3110410,709535,800701,-91166
2023,2,3110409,576600,712154,-135554
2023,2,3110408,384258,408926,-24668
2023,2,3110407,1058615,943161,115454
2023,2,3110406,204377,202567,1810
2023,2,3110405,1448162,1463636,-15474
2023,2,3110404,3342523,3385640,-43117
2023,2,3110403,1265212,1669506,-404294
2023,2,3110402,724123,719539,4584
2023,2,3110401,169125,173682,-4557
2023,2,3110400,1257869,1287865,-29996
2023,2,3110399,1833265,1868770,-35505
2023,2,3110398,835276,918454,-83178
2023,2,3110397,1595997,1764165,-168168
2023,2,3110396,907986,1026713,-118727
2023,2,3110395,309788,295969,13819
2023,2,3110394,1221481,1072016,149465
2023,2,3110393,39685,71189,-31504
2023,2,3110392,96935,150932,-53997
2023,2,3110391,478423,544022,-65599
2023,2,3110390,555779,543101,12678
2023,2,3110389,395388,382517,12871
2023,2,3110388,772301,679011,93290
2023,2,3110387,1538197,1724375,-186178
2023,2,3110383,81422,114240,-32818
2023,2,3110382,592714,633934,-41220
2023,2,3110381,426386,422801,3585
2023,2,3110380,646928,692066,-45138
2023,2,3110379,156178,158956,-2778
2023,2,3110378,757472,828278,-70806
2023,2,3110377,852586,768717,83869
2023,2,3110376,2923279,3109472,-186193
2023,2,3110375,655782,610797,44985
2023,2,3110374,2674801,2367105,307696
2023,2,3110373,1214845,1259502,-44657
2023,2,3110372,1581483,1732901,-151418
2023,2,3110371,708397,697187,11210
2023,2,3110370,1295291,1303270,-7979
2023,2,3110369,1357131,1127198,229933
2023,2,3110368,2771199,2921828,-150629
2023,2,3110367,1271517,1459541,-188024
2023,2,3110366,566283,621851,-55568
2023,2,3110365,1940305,1755445,184860
2023,2,3110364,1472652,1634770,-162118
2023,2,3110363,241083,296289,-55206
2023,2,3110362,871780,840394,31386
2023,2,3110361,1183779,931280,252499
2023,2,3110360,1155826,1291804,-135978
2023,2,3110359,1507341,1019028,488313
2023,2,3110358,1021856,1006406,15450
2023,2,3110357,976184,1066906,-90722
2023,2,3110356,938030,1074859,-136829
2023,2,3110355,1726512,1342034,384478
2023,2,3110354,63545,84020,-20475
2023,2,3110353,740893,806727,-65834
2023,2,3110352,1598556,1712558,-114002
2023,2,3110351,609875,636785,-26910
2023,2,3110350,509174,530610,-21436
2023,2,3110349,627036,678333,-51297
2023,2,3110348,2028744,2123446,-94702
2023,2,3110346,1108698,647981,460717
2023,2,3110345,708215,709289,-1074
2023,2,3110344,358609,374391,-15782
2023,2,3110343,780343,902247,-121904
2023,2,3110342,985356,1029568,-44212
2023,2,3110341,236525,246490,-9965
2023,2,3110340,348620,330843,17777
2023,2,3110337,445056,493168,-48112
2023,2,3110336,350875,348189,2686
2023,2,3110335,1239511,1328851,-89340
2023,2,3110334,2187842,1997853,189989
2023,2,3110333,640428,655716,-15288
2023,2,3110332,291616,283434,8182
2023,2,3110331,1141918,1239690,-97772
2023,2,3110330,873642,910665,-37023
2023,2,3110329,606333,492077,114256
2023,2,3110328,1061562,1073058,-11496
2023,2,3110327,952386,962011,-9625
2023,2,3110326,454802,461489,-6687
2023,2,3110325,1042048,1076470,-34422
2023,2,3110323,1409163,1615081,-205918
2023,2,3110322,754905,775383,-20478
2023,2,3110320,198055,193923,4132
2023,2,3110319,1213902,1146000,67902
2023,2,3110318,1166056,1369324,-203268
2023,2,3110317,812004,705701,106303
2023,2,3110316,2935021,3096574,-161553
2023,2,3110315,1592939,1611645,-18706
2023,2,3110314,750860,761819,-10959
2023,2,3110313,1887889,1611308,276581
2023,2,3110312,560015,608149,-48134
2023,2,3110310,39100,33946,5154
2023,2,3110309,406762,371218,35544
2023,2,3110308,999841,1041923,-42082
2023,2,3110307,709893,714514,-4621
2023,2,3110306,193351,168749,24602
2023,2,3110305,2023888,2035453,-11565
2023,2,3110304,1055066,1015252,39814
2023,2,3110303,1334945,1453511,-118566
2023,2,3110302,288888,257678,31210
2023,2,3110301,1601912,1564850,37062
2023,2,3110300,3007715,3073358,-65643
2023,2,3110299,1821987,1880337,-58350
2023,2,3110298,298555,334438,-35883
2023,2,3110297,2382683,2183008,199675
2023,2,3110296,910896,986572,-75676
2023,2,3110295,922173,940813,-18640
2023,2,3110294,1564335,1582890,-18555
2023,2,3110293,1511382,1480027,31355
2023,2,3110292,309528,322196,-12668
2023,2,3110291,2240138,2178889,61249
2023,2,3110290,203221,209742,-6521
2023,2,3110289,1403700,1473594,-69894
2023,2,3110288,334623,327674,6949
2023,2,3110287,248642,240131,8511
2023,2,3110286,975567,712866,262701
2023,2,3110285,151530,139109,12421
2023,2,3110284,92804,97846,-5042
2023,2,3110283,145907,162205,-16298
2023,2,3110282,41671,41371,300
2023,2,3110281,72400,80121,-7721
2023,2,3110280,285467,280180,5287
2023,2,3110278,839143,867184,-28041
2023,2,3110277,877495,1240315,-362820
2023,2,3110276,46609,48728,-2119
2023,2,3110275,545130,464534,80596
2023,2,3110274,1250420,1290060,-39640
2023,2,3110273,731722,776268,-44546
2023,2,3110272,1272166,1279046,-6880
2023,2,3110271,48315,49119,-804
2023,2,3110270,304315,448837,-144522
2023,2,3110269,486719,469967,16752
2023,2,3110268,543443,527427,16016
2023,2,3110267,1296430,1400229,-103799
2023,2,3110266,1587599,1644716,-57117
2023,2,3110265,486196,494765,-8569
2023,2,3110264,2894973,3036991,-142018
2023,2,3110263,1303958,1349689,-45731
2023,2,3110262,1896837,1869879,26958
2023,2,3110261,1491810,1508020,-16210
2023,2,3110260,1350549,1540585,-190036
2023,2,3110259,1527905,1498025,29880
2023,2,3110258,744664,655545,89119
2023,2,3110257,2072072,1837508,234564
2023,2,3110256,1613478,1649692,-36214
2023,2,3110255,2046728,2051886,-5158
2023,2,3110254,3168004,3598471,-430467
2023,2,3110253,847579,784118,63461
2023,2,3110252,1015969,865353,150616
2023,2,3110251,640887,756523,-115636
2023,2,3110250,498612,482127,16485
2023,2,3110249,1803354,2147041,-343687
2023,2,3110248,574561,584881,-10320
2023,2,3110247,2224205,2221751,2454
2023,2,3110246,1414048,1421144,-7096
2023,2,3110245,546435,519295,27140
2023,2,3110244,1191832,897272,294560
2023,2,3110243,620962,995600,-374638
2023,2,3110242,508173,758425,-250252
2023,2,3110241,1033631,1144677,-111046
2023,2,3110240,671633,706854,-35221
2023,2,3110238,74484,92634,-18150
2023,2,3110237,950881,1019981,-69100
2023,2,3110236,1958767,2006627,-47860
2023,2,3110234,332993,324122,8871
2023,2,3110233,1199517,1209819,-10302
2023,2,3110232,848323,865107,-16784
2023,2,3110230,1026978,1029723,-2745
2023,2,3110229,1858461,1832050,26411
2023,2,3110228,1587834,1590439,-2605
2023,2,3110227,506270,597491,-91221
2023,2,3110226,2768026,2610360,157666
2023,2,3110225,195347,253750,-58403
2023,2,3110224,693315,601349,91966
2023,2,3110221,274964,263156,11808
2023,2,3110220,1330192,1245187,85005
2023,2,3110219,1592606,1714629,-122023
2023,2,3110218,1316537,1318569,-2032
2023,2,3110217,594006,651972,-57966
2023,2,3110216,345538,346717,-1179
2023,2,3110215,783032,758866,24166
2023,2,3110214,1847030,1672642,174388
2023,2,3110213,611613,578923,32690
2023,2,3110212,1046456,1109208,-62752
2023,2,3110211,2241842,2537592,-295750
2023,2,3110210,2334960,2404780,-69820
2023,2,3110209,315852,321524,-5672
2023,2,3110208,382222,386438,-4216
2023,2,3110207,490204,594689,-104485
2023,2,3110206,1195191,1540698,-345507
2023,2,3110205,2300244,2204803,95441
2023,2,3110204,1242586,1445184,-202598
2023,2,3110203,954656,628526,326130
2023,2,3110201,122820,142532,-19712
2023,2,3110200,378671,440932,-62261
2023,2,3110199,261573,417005,-155432
2023,2,3110197,265764,296677,-30913
2023,2,3110195,1503019,1496186,6833
2023,2,3110194,333583,447736,-114153
2023,2,3110193,815201,833562,-18361
2023,2,3110191,1935372,1508679,426693
2023,2,3110190,1028069,1415601,-387532
2023,2,3110189,996386,932253,64133
2023,2,3110188,796110,961409,-165299
2023,2,3110187,2712138,2843686,-131548
2023,2,3110186,159285,154079,5206
2023,2,3110185,713228,726883,-13655
2023,2,3110184,316876,288344,28532
2023,2,3110183,649089,620785,28304
2023,2,3110182,996307,851319,144988
2023,2,3110181,1342052,1386503,-44451
2023,2,3110180,239003,247010,-8007
2023,2,3110179,427297,542984,-115687
2023,2,3110178,331698,339385,-7687
2023,2,3110177,130832,90207,40625
2023,2,3110176,1200920,1413866,-212946
2023,2,3110175,1222299,1200157,22142
2023,2,3110174,805814,874561,-68747
2023,2,3110173,350024,411352,-61328
2023,2,3110172,967774,798926,168848
2023,2,3110171,321109,348950,-27841
2023,2,3110170,2407852,3055354,-647502
2023,2,3110169,546382,657075,-110693
2023,2,3110168,481370,492138,-10768
2023,2,3110167,1709111,1758437,-49326
2023,2,3110166,2083893,2155444,-71551
2023,2,3110165,741586,746841,-5255
2023,2,3110164,478106,505112,-27006
2023,2,3110163,585371,696592,-111221
2023,2,3110162,482442,520308,-37866
2023,2,3110161,659212,982048,-322836
2023,2,3110160,558644,535087,23557
2023,2,3110159,3551628,3357589,194039
2023,2,3110158,2805518,2594629,210889
2023,2,3110157,1397739,1407136,-9397
2023,2,3110156,1095304,1151941,-56637
2023,2,3110155,1043501,980090,63411
2023,2,3110154,1643892,2117625,-473733
2023,2,3110153,304371,297003,7368
2023,2,3110152,258209,260441,-2232
2023,2,3110151,1341999,1293523,48476
2023,2,3110150,1848696,1848012,684
2023,2,3110149,250007,246919,3088
2023,2,3110148,645633,632963,12670
2023,2,3110147,922630,946352,-23722
2023,2,3110146,1362058,1666586,-304528
2023,2,3110144,420988,404297,16691
2023,2,3110142,2082622,1993949,88673
2023,2,3110141,1806409,1970820,-164411
2023,2,3110140,2348249,2216102,132147
2023,2,3110139,2049129,2141986,-92857
2023,2,3110138,1022218,1303581,-281363
2023,2,3110137,1551078,1468893,82185
2023,2,3110136,1113668,1284699,-171031
2023,2,3110135,299576,227259,72317
2023,2,3110134,1408138,1488632,-80494
2023,2,3110133,366017,371913,-5896
2023,2,3110132,529716,555857,-26141
2023,2,3110131,846142,756083,90059
2023,2,3110130,603545,485224,118321
2023,2,3110129,184089,186356,-2267
2023,2,3110128,1232627,1354214,-121587
2023,2,3110127,172951,152448,20503
2023,2,3110126,341760,389273,-47513
2023,2,3110125,1070775,1044934,25841
2023,2,3110124,228633,362952,-134319
2023,2,3110123,871254,806727,64527
2023,2,3110122,294291,310670,-16379
2023,2,3110121,223138,166309,56829
2023,2,3110120,373423,511957,-138534
2023,2,3110118,997778,652901,344877
2023,2,3110117,456983,483636,-26653
2023,2,3110116,578948,656014,-77066
2023,2,3110115,741747,764127,-22380
2023,2,3110114,384263,436376,-52113
2023,2,3110113,157193,174661,-17468
2023,2,3110112,768821,893930,-125109
2023,2,3110110,1000445,1018634,-18189
2023,2,3110109,341231,316311,24920
2023,2,3110107,65530,67051,-1521
2023,2,3110105,763427,911665,-148238
2023,2,3110104,1152031,1261816,-109785
2023,2,3110103,280970,243264,37706
2023,2,3110102,579981,615301,-35320
2023,2,3110099,241350,345804,-104454
2023,2,3110098,86886,90469,-3583
2023,2,3110096,242836,263208,-20372
2023,2,3110095,492560,505322,-12762
2023,2,3110093,2441936,2557210,-115274
2023,2,3110092,752876,672368,80508
2023,2,3110090,609204,657679,-48475
2023,2,3110089,474325,522949,-48624
2023,2,3110088,386652,403105,-16453
2023,2,3110087,234262,284486,-50224
2023,2,3110085,1340495,1356533,-16038
2023,2,3110084,998609,965725,32884
2023,2,3110083,90764,96737,-5973
2023,2,3110082,388775,374960,13815
2023,2,3110081,1668099,1940832,-272733
2023,2,3110080,1685641,1491485,194156
2023,2,3110079,1955463,2144714,-189251
2023,2,3110078,94289,117853,-23564
2023,2,3110077,541441,541269,172
2023,2,3110075,798854,879191,-80337
2023,2,3110074,762280,820229,-57949
2023,2,3110073,253646,130985,122661
2023,2,3110071,64159,53271,10888
2023,2,3110070,53019,65743,-12724
2023,2,3110069,2397204,2649891,-252687
2023,2,3110068,1680512,1718729,-38217
2023,2,3110067,2320682,2478664,-157982
2023,2,3110066,1447691,1364339,83352
2023,2,3110065,60294,59953,341
2023,2,3110064,1352699,1527892,-175193
2023,2,3110063,979544,929316,50228
2023,2,3110062,799269,887935,-88666
2023,2,3110061,1220456,1272735,-52279
2023,2,3110060,667525,612103,55422
2023,2,3110059,571370,969056,-397686
2023,2,3110058,1528950,1460928,68022
2023,2,3110057,759302,842719,-83417
2023,2,3110056,1668414,1989340,-320926
2023,2,3110055,499943,538969,-39026
2023,2,3110054,1060893,980926,79967
2023,2,3110053,855092,1105407,-250315
2023,2,3110052,639425,592403,47022
2023,2,3110051,1021382,947934,73448
2023,2,3110050,466220,402512,63708
2023,2,3110049,726647,722142,4505
2023,2,3110048,946943,850656,96287
2023,2,3110047,577092,605887,-28795
2023,2,3110045,684749,673529,11220
2023,2,3110043,864530,832270,32260
2023,2,3110042,206569,196077,10492
2023,2,3110041,342901,344233,-1332
2023,2,3110040,171874,185333,-13459
2023,2,3110039,90913,97249,-6336
2023,2,3110037,847961,896186,-48225
2023,2,3110036,345949,398489,-52540
2023,2,3110035,1361755,1342314,19441
2023,2,3110033,667689,712873,-45184
2023,2,3110031,63269,60283,2986
2023,2,3110030,146490,153008,-6518
2023,2,3110029,3267993,3272392,-4399
2023,2,3110028,2513717,2739676,-225959
2023,2,3110027,381344,391012,-9668
2023,2,3110025,354019,247921,106098
2023,2,3110024,330046,331171,-1125
2023,2,3110023,392224,392319,-95
2023,2,3110022,559314,577631,-18317
2023,2,3110021,1577966,1451559,126407
2023,2,3110020,2096416,2006874,89542
2023,2,3110018,484016,509838,-25822
2023,2,3110017,477038,504486,-27448
2023,2,3110016,31703,37499,-5796
2023,2,3110014,64780,65215,-435
2023,2,3110012,598915,628807,-29892
2023,2,3110010,143896,172284,-28388
2023,2,3110009,162608,176832,-14224
2023,2,3110008,1313974,1347671,-33697
2023,2,3110007,892724,879354,13370
2023,2,3110006,7589,7100,489
2023,2,3110005,111693,136605,-24912
2023,2,3110004,657601,553295,104306
2023,2,3110003,536705,712418,-175713
2023,2,3110002,556223,581730,-25507
2023,2,3110001,130564,125747,4817
2023,1,3111089,872148,801156,70992
2023,1,3111088,307998,331682,-23684
2023,1,3111087,206443,212760,-6317
2023,1,3111086,393189,355474,37715
2023,1,3111085,854763,850471,4292
2023,1,3111084,182779,186188,-3409
2023,1,3111083,839276,992773,-153497
2023,1,3111082,141661,184383,-42722
2023,1,3111080,614949,554752,60197
2023,1,3111079,383310,398257,-14947
2023,1,3111078,4038294,4210186,-171892
2023,1,3111077,3335617,3481402,-145785
2023,1,3111076,409177,465820,-56643
2023,1,3111075,1408199,1665098,-256899
2023,1,3111074,566826,648389,-81563
2023,1,3111073,3747715,3739610,8105
2023,1,3111072,1851666,2201336,-349670
2023,1,3111071,673324,443035,230289
2023,1,3111070,1535004,1502175,32829
2023,1,3111069,2635861,2847926,-212065
2023,1,3111068,254967,232613,22354
2023,1,3111067,2664330,2754968,-90638
2023,1,3111066,1399544,1113036,286508
2023,1,3111065,552041,611025,-58984
2023,1,3111064,465318,603485,-138167
2023,1,3111063,1436623,1455616,-18993
2023,1,3111062,936218,872955,63263
2023,1,3111061,2848814,3336378,-487564
2023,1,3111060,3331945,3333806,-1861
2023,1,3111059,3222278,3532807,-310529
2023,1,3111058,509409,478737,30672
2023,1,3111057,795994,986187,-190193
2023,1,3111056,361942,325150,36792
2023,1,3111055,30394,17256,13138
2023,1,3111054,214546,147792,66754
2023,1,3111053,1139917,1133900,6017
2023,1,3111052,1528019,1165205,362814
2023,1,3111051,2865149,3000693,-135544
2023,1,3111049,1337270,1252683,84587
2023,1,3111047,276466,373952,-97486
2023,1,3111046,2060861,2031413,29448
2023,1,3111045,289592,282422,7170
2023,1,3111044,1362422,1425440,-63018
2023,1,3111043,669158,756412,-87254
2023,1,3111042,2083844,1835977,247867
2023,1,3111040,882169,642265,239904
2023,1,3111039,1036899,1021381,15518
2023,1,3111038,568546,404220,164326
2023,1,3111037,245121,243349,1772
2023,1,3111036,397733,380605,17128
2023,1,3111035,700695,879488,-178793
2023,1,3111034,747393,847741,-100348
2023,1,3111033,45774,46885,-1111
2023,1,3111032,388294,427983,-39689
2023,1,3111031,934426,982774,-48348
2023,1,3111030,1510669,1235619,275050
2023,1,3111029,213137,190553,22584
2023,1,3111028,837600,929655,-92055
2023,1,3111027,935695,924634,11061
2023,1,3111026,923260,902337,20923
2023,1,3111025,931903,989809,-57906
2023,1,3111024,354827,396141,-41314
2023,1,3111023,899236,857392,41844
2023,1,3111022,381044,384493,-3449
2023,1,3111021,2555139,2474376,80763
2023,1,3111020,235779,231368,4411
2023,1,3111019,1514379,1364796,149583
2023,1,3111017,175264,183727,-8463
2023,1,3111016,679918,664869,15049
2023,1,3111015,1800909,2014305,-213396
2023,1,3111014,776950,715736,61214
2023,1,3111013,2472965,2353587,119378
2023,1,3111012,952274,1038203,-85929
2023,1,3111011,41434,38164,3270
2023,1,3111010,1654824,1922217,-267393
2023,1,3111009,251590,234152,17438
2023,1,3111008,699552,754410,-54858
2023,1,3111007,1139869,1259536,-119667
2023,1,3111006,2006368,2376820,-370452
2023,1,3111005,1496214,1474491,21723
2023,1,3111004,2210290,2334280,-123990
2023,1,3111003,2131112,2138505,-7393
2023,1,3111001,42337,50857,-8520
2023,1,3110999,160772,154658,6114
2023,1,3110997,2008624,2180094,-171470
2023,1,3110996,860862,763227,97635
2023,1,3110995,597904,581913,15991
2023,1,3110994,423681,439755,-16074
2023,1,3110992,1977485,2019617,-42132
2023,1,3110989,634683,632049,2634
2023,1,3110988,135740,128211,7529
2023,1,3110984,891291,952631,-61340
2023,1,3110983,444828,436972,7856
2023,1,3110982,348031,373557,-25526
2023,1,3110981,413131,415104,-1973
2023,1,3110980,527837,513628,14209
2023,1,3110979,306041,327912,-21871
2023,1,3110976,766653,651122,115531
2023,1,3110975,306208,274529,31679
2023,1,3110974,375696,426787,-51091
2023,1,3110973,1148781,1133377,15404
2023,1,3110972,307863,354565,-46702
2023,1,3110971,792789,803559,-10770
2023,1,3110970,339722,350891,-11169
2023,1,3110969,904763,766363,138400
2023,1,3110968,295373,295260,113
2023,1,3110967,583990,673492,-89502
2023,1,3110966,1752562,1580844,171718
2023,1,3110961,884803,725302,159501
2023,1,3110959,122934,48944,73990
2023,1,3110958,688778,561770,127008
2023,1,3110957,880510,844555,35955
2023,1,3110956,687906,349522,338384
2023,1,3110955,2692307,2923300,-230993
2023,1,3110954,505187,410826,94361
2023,1,3110953,421690,406338,15352
2023,1,3110952,221754,241082,-19328
2023,1,3110951,573497,532080,41417
2023,1,3110949,377078,349095,27983
2023,1,3110947,20817,37980,-17163
2023,1,3110945,32255,31170,1085
2023,1,3110943,480478,505905,-25427
2023,1,3110942,1741991,1785549,-43558
2023,1,3110940,393086,362731,30355
2023,1,3110939,2042097,1924173,117924
2023,1,3110936,225370,192389,32981
2023,1,3110935,635504,537236,98268
2023,1,3110934,416702,441247,-24545
2023,1,3110932,245205,239800,5405
2023,1,3110931,22502,20789,1713
2023,1,3110930,493610,591716,-98106
2023,1,3110929,1645112,1548382,96730
2023,1,3110926,910619,1122465,-211846
2023,1,3110925,575659,613786,-38127
2023,1,3110924,396796,448208,-51412
2023,1,3110922,968786,874396,94390
2023,1,3110921,351206,467622,-116416
2023,1,3110919,607351,680565,-73214
2023,1,3110918,1064459,1079318,-14859
2023,1,3110917,116810,116101,709
2023,1,3110916,736291,844869,-108578
2023,1,3110915,193340,195378,-2038
2023,1,3110913,831680,887405,-55725
2023,1,3110912,158674,220089,-61415
2023,1,3110910,396488,358519,37969
2023,1,3110908,22278,23636,-1358
2023,1,3110907,932361,873084,59277
2023,1,3110906,500180,577893,-77713
2023,1,3110905,399196,451390,-52194
2023,1,3110904,325707,249590,76117
2023,1,3110903,795375,841182,-45807
2023,1,3110902,2584699,2338048,246651
2023,1,3110901,1232951,1145970,86981
2023,1,3110900,1806475,1918266,-111791
2023,1,3110899,864787,918722,-53935
2023,1,3110897,1568928,1545761,23167
2023,1,3110896,187154,195907,-8753
2023,1,3110895,3935303,3993334,-58031
2023,1,3110893,83116,83776,-660
2023,1,3110892,4467751,4758955,-291204
2023,1,3110891,221833,166943,54890
2023,1,3110890,842790,845689,-2899
2023,1,3110889,502096,479274,22822
2023,1,3110888,740416,722734,17682
2023,1,3110887,526918,421117,105801
2023,1,3110886,1177696,1158987,18709
2023,1,3110885,1450027,1552291,-102264
2023,1,3110884,741009,757720,-16711
2023,1,3110883,1293589,1140010,153579
2023,1,3110882,1650963,1756755,-105792
2023,1,3110881,4930552,4340212,590340
2023,1,3110880,478090,504027,-25937
2023,1,3110879,287193,297282,-10089
2023,1,3110878,757272,862806,-105534
2023,1,3110877,1304010,1372733,-68723
2023,1,3110876,519644,512218,7426
2023,1,3110875,155411,189374,-33963
2023,1,3110874,1661793,1908864,-247071
2023,1,3110873,594699,641511,-46812
2023,1,3110872,882562,874729,7833
2023,1,3110871,783915,744295,39620
2023,1,3110869,4331021,4398774,-67753
2023,1,3110868,686393,828765,-142372
2023,1,3110867,1303055,1313751,-10696
2023,1,3110866,1191609,1312109,-120500
2023,1,3110865,2149041,2370340,-221299
2023,1,3110864,1560223,1854599,-294376
2023,1,3110863,823959,958232,-134273
2023,1,3110862,385569,761475,-375906
2023,1,3110861,1951100,2066088,-114988
2023,1,3110860,449763,483655,-33892
2023,1,3110859,520443,592805,-72362
2023,1,3110858,627194,503763,123431
2023,1,3110857,1202522,1170324,32198
2023,1,3110856,833627,872839,-39212
2023,1,3110855,978447,1292683,-314236
2023,1,3110854,390108,390326,-218
2023,1,3110853,1834070,1709781,124289
2023,1,3110852,595325,722895,-127570
2023,1,3110851,1389731,1065152,324579
2023,1,3110850,2652894,2513013,139881
2023,1,3110849,2076674,1899239,177435
2023,1,3110848,1375081,1515412,-140331
2023,1,3110847,819515,930888,-111373
2023,1,3110846,2771202,2835167,-63965
2023,1,3110845,345234,435638,-90404
2023,1,3110843,480697,476889,3808
2023,1,3110842,165067,151930,13137
2023,1,3110841,945494,1450760,-505266
2023,1,3110840,1291724,784643,507081
2023,1,3110839,807125,706545,100580
2023,1,3110838,144940,148795,-3855
2023,1,3110837,1683930,1876731,-192801
2023,1,3110836,1463064,1584153,-121089
2023,1,3110835,195094,144947,50147
2023,1,3110833,594216,578716,15500
2023,1,3110832,603165,561436,41729
2023,1,3110831,558509,547612,10897
2023,1,3110830,570492,597684,-27192
2023,1,3110829,817262,754526,62736
2023,1,3110828,1791420,1789981,1439
2023,1,3110827,606273,576666,29607
2023,1,3110826,601421,715006,-113585
2023,1,3110825,2328513,2029731,298782
2023,1,3110824,207238,258166,-50928
2023,1,3110823,851323,652380,198943
2023,1,3110822,728354,567501,160853
2023,1,3110821,1424230,1420552,3678
2023,1,3110820,790225,885604,-95379
2023,1,3110819,921557,901507,20050
2023,1,3110818,401390,135463,265927
2023,1,3110817,374756,328142,46614
2023,1,3110816,917232,694848,222384
2023,1,3110815,1137934,1578356,-440422
2023,1,3110814,1255151,1469821,-214670
2023,1,3110813,1368542,1288512,80030
2023,1,3110812,570638,603720,-33082
2023,1,3110811,476943,421592,55351
2023,1,3110810,1520133,1683668,-163535
2023,1,3110809,431955,390160,41795
2023,1,3110807,472268,455823,16445
2023,1,3110805,322935,360008,-37073
2023,1,3110804,972997,896606,76391
2023,1,3110803,1299772,1357315,-57543
2023,1,3110802,581888,604861,-22973
2023,1,3110800,139417,150103,-10686
2023,1,3110799,173551,175307,-1756
2023,1,3110798,138926,134555,4371
2023,1,3110796,95828,85801,10027
2023,1,3110795,1080603,1185710,-105107
2023,1,3110794,1002729,855712,147017
2023,1,3110792,1993975,2299743,-305768
2023,1,3110791,118601,75715,42886
2023,1,3110790,691287,745092,-53805
2023,1,3110789,572185,592847,-20662
2023,1,3110788,98205,81853,16352
2023,1,3110787,1442249,1324112,118137
2023,1,3110786,413628,403120,10508
2023,1,3110785,1163409,1162005,1404
2023,1,3110784,188780,198549,-9769
2023,1,3110783,257772,218856,38916
2023,1,3110782,201160,187304,13856
2023,1,3110781,1330948,1386590,-55642
2023,1,3110780,374195,325720,48475
2023,1,3110778,1304493,1249506,54987
2023,1,3110777,302626,242711,59915
2023,1,3110776,821401,842430,-21029
2023,1,3110775,289348,297983,-8635
2023,1,3110774,473459,509030,-35571
2023,1,3110772,314073,341283,-27210
2023,1,3110771,419804,388516,31288
2023,1,3110770,696413,665265,31148
2023,1,3110769,659863,507419,152444
2023,1,3110768,256889,221828,35061
2023,1,3110767,220421,272358,-51937
2023,1,3110766,1290557,1263682,26875
2023,1,3110765,353008,321741,31267
2023,1,3110762,1681206,1791134,-109928
2023,1,3110760,811466,737380,74086
2023,1,3110758,308160,377432,-69272
2023,1,3110757,214718,210609,4109
2023,1,3110756,209241,217812,-8571
2023,1,3110755,247436,263103,-15667
2023,1,3110754,1480953,1462191,18762
2023,1,3110753,933414,1063024,-129610
2023,1,3110752,778751,819578,-40827
2023,1,3110751,1039505,1019673,19832
2023,1,3110750,761614,834582,-72968
2023,1,3110749,583365,618282,-34917
2023,1,3110748,387830,367146,20684
2023,1,3110747,167735,190874,-23139
2023,1,3110746,202369,225028,-22659
2023,1,3110745,422897,504244,-81347
2023,1,3110744,1697840,1678409,19431
2023,1,3110743,796807,984537,-187730
2023,1,3110742,74236,66535,7701
2023,1,3110741,572882,644872,-71990
2023,1,3110740,1841289,1592264,249025
2023,1,3110739,28222,27620,602
2023,1,3110738,810525,888646,-78121
2023,1,3110737,1365804,1619178,-253374
2023,1,3110736,867521,801900,65621
2023,1,3110735,948351,1172527,-224176
2023,1,3110734,40805,21796,19009
2023,1,3110733,286625,220608,66017
2023,1,3110732,413557,356995,56562
2023,1,3110731,384015,425475,-41460
2023,1,3110730,587558,542033,45525
2023,1,3110729,656588,621273,35315
2023,1,3110728,193981,181904,12077
2023,1,3110727,403088,362804,40284
2023,1,3110726,503473,261588,241885
2023,1,3110725,181044,209818,-28774
2023,1,3110724,588947,633713,-44766
2023,1,3110723,310103,294358,15745
2023,1,3110722,330685,344838,-14153
2023,1,3110721,1215134,1117754,97380
2023,1,3110720,940739,1020832,-80093
2023,1,3110719,313423,276896,36527
2023,1,3110718,921840,956094,-34254
2023,1,3110717,2990568,3072496,-81928
2023,1,3110716,419354,420076,-722
2023,1,3110715,314140,291772,22368
2023,1,3110714,1476296,1559617,-83321
2023,1,3110713,2920092,2863409,56683
2023,1,3110712,2305657,2176182,129475
2023,1,3110711,1258445,1336367,-77922
2023,1,3110710,2347090,2388705,-41615
2023,1,3110709,1266790,1334174,-67384
2023,1,3110708,372756,339760,32996
2023,1,3110707,1070621,1126870,-56249
2023,1,3110706,183582,270649,-87067
2023,1,3110703,680865,613918,66947
2023,1,3110702,714941,1010563,-295622
2023,1,3110701,671764,727055,-55291
2023,1,3110700,922256,1019522,-97266
2023,1,3110699,473312,517434,-44122
2023,1,3110698,687718,721841,-34123
2023,1,3110697,500509,623488,-122979
2023,1,3110696,743752,629694,114058
2023,1,3110695,1661527,1660574,953
2023,1,3110694,1904338,1911433,-7095
2023,1,3110693,145018,104708,40310
2023,1,3110692,899197,1077617,-178420
2023,1,3110691,600443,737252,-136809
2023,1,3110690,1867812,1963429,-95617
2023,1,3110689,1031604,675883,355721
2023,1,3110688,824240,954027,-129787
2023,1,3110687,61069,176837,-115768
2023,1,3110686,1371839,760077,611762
2023,1,3110684,72141,49800,22341
2023,1,3110683,259057,277553,-18496
2023,1,3110681,26722,29358,-2636
2023,1,3110680,210656,236561,-25905
2023,1,3110679,216563,253373,-36810
2023,1,3110678,151681,164185,-12504
2023,1,3110677,218060,187431,30629
2023,1,3110676,443504,464627,-21123
2023,1,3110675,1603198,1739619,-136421
2023,1,3110673,776871,592521,184350
2023,1,3110672,752041,691233,60808
2023,1,3110671,1985166,2159932,-174766
2023,1,3110670,1510223,1653313,-143090
2023,1,3110668,1578731,1889077,-310346
2023,1,3110666,229619,197523,32096
2023,1,3110665,2112345,1201859,910486
2023,1,3110664,247748,233563,14185
2023,1,3110663,303628,262538,41090
2023,1,3110662,2256602,2758243,-501641
2023,1,3110661,336187,290656,45531
2023,1,3110660,715046,666931,48115
2023,1,3110659,4928147,5074298,-146151
2023,1,3110658,802458,943401,-140943
2023,1,3110657,621522,663164,-41642
2023,1,3110656,7012938,6296885,716053
2023,1,3110655,314949,363469,-48520
2023,1,3110654,2442823,2485026,-42203
2023,1,3110653,954014,1036098,-82084
2023,1,3110652,338550,303768,34782
2023,1,3110651,497509,554056,-56547
2023,1,3110650,73383,80512,-7129
2023,1,3110649,1002357,992493,9864
2023,1,3110647,2399853,2499254,-99401
2023,1,3110646,1859438,1823411,36027
2023,1,3110645,1231148,1326545,-95397
2023,1,3110644,83023,94755,-11732
2023,1,3110643,555244,784535,-229291
2023,1,3110641,273069,252779,20290
2023,1,3110640,571825,587910,-16085
2023,1,3110639,640013,404448,235565
2023,1,3110638,2370496,2272492,98004
2023,1,3110637,182707,196799,-14092
2023,1,3110636,699293,642087,57206
2023,1,3110635,259147,287451,-28304
2023,1,3110634,2083951,1983977,99974
2023,1,3110633,51788,57655,-5867
2023,1,3110632,695307,709151,-13844
2023,1,3110631,588891,635087,-46196
2023,1,3110630,1616875,1763573,-146698
2023,1,3110629,149586,160018,-10432
2023,1,3110628,317998,266591,51407
2023,1,3110627,1497000,1239504,257496
2023,1,3110626,1506529,1546857,-40328
2023,1,3110625,805654,564852,240802
2023,1,3110624,532545,531063,1482
2023,1,3110622,523433,503154,20279
2023,1,3110621,170069,267785,-97716
2023,1,3110620,2058533,2280480,-221947
2023,1,3110619,344107,347525,-3418
2023,1,3110618,1688392,1603362,85030
2023,1,3110617,525058,580349,-55291
2023,1,3110616,250846,241463,9383
2023,1,3110615,264285,232378,31907
2023,1,3110614,411863,524893,-113030
2023,1,3110613,216323,258270,-41947
2023,1,3110612,2055298,2142120,-86822
2023,1,3110611,1239457,1168089,71368
2023,1,3110609,921965,999477,-77512
2023,1,3110608,1446160,1650608,-204448
2023,1,3110607,173308,161434,11874
2023,1,3110606,1427523,1465819,-38296
2023,1,3110605,49961,45096,4865
2023,1,3110604,1001595,1175059,-173464
2023,1,3110603,86708,84479,2229
2023,1,3110602,187818,194982,-7164
2023,1,3110601,1436070,1442023,-5953
2023,1,3110600,458619,570081,-111462
2023,1,3110599,877875,1150199,-272324
2023,1,3110598,565008,564850,158
2023,1,3110597,1150521,1254586,-104065
2023,1,3110596,615250,632843,-17593
2023,1,3110595,582158,560880,21278
2023,1,3110594,342771,364475,-21704
2023,1,3110593,1015368,1136387,-121019
2023,1,3110592,247438,254239,-6801
2023,1,3110591,1218283,1458461,-240178
2023,1,3110590,1783223,1528265,254958
2023,1,3110589,145034,107084,37950
2023,1,3110588,1074770,1037951,36819
2023,1,3110587,659664,895965,-236301
2023,1,3110586,1740570,1805522,-64952
2023,1,3110585,116630,139522,-22892
2023,1,3110584,96543,102282,-5739
2023,1,3110583,389388,382664,6724
2023,1,3110582,541351,531648,9703
2023,1,3110580,788484,761807,26677
2023,1,3110579,333045,315125,17920
2023,1,3110578,2585725,1260925,1324800
2023,1,3110577,571416,618820,-47404
2023,1,3110576,1272747,1164745,108002
2023,1,3110575,1082726,1075024,7702
2023,1,3110574,57060,48543,8517
2023,1,3110573,109213,98218,10995
2023,1,3110572,1843350,1826283,17067
2023,1,3110571,484924,520824,-35900
2023,1,3110570,203652,214525,-10873
2023,1,3110569,863081,927919,-64838
2023,1,3110568,288660,315024,-26364
2023,1,3110567,285282,278686,6596
2023,1,3110566,1631615,1434633,196982
2023,1,3110565,437683,412428,25255
2023,1,3110564,997598,710994,286604
2023,1,3110563,156604,204957,-48353
2023,1,3110562,993876,1017850,-23974
2023,1,3110561,732267,754455,-22188
2023,1,3110560,1020194,1100455,-80261
2023,1,3110559,864651,880143,-15492
2023,1,3110558,2798481,2454084,344397
2023,1,3110557,820359,902093,-81734
2023,1,3110555,250540,189282,61258
2023,1,3110554,1034704,883692,151012
2023,1,3110553,1009604,810763,198841
2023,1,3110552,680317,790608,-110291
2023,1,3110551,1457597,1499466,-41869
2023,1,3110550,1785235,1723047,62188
2023,1,3110549,904460,1255035,-350575
2023,1,3110548,1216107,1133676,82431
2023,1,3110547,819938,828527,-8589
2023,1,3110546,743548,776498,-32950
2023,1,3110545,557392,586197,-28805
2023,1,3110544,4839892,5132483,-292591
2023,1,3110543,136736,86455,50281
2023,1,3110542,1422742,1556603,-133861
2023,1,3110541,1146718,1319105,-172387
2023,1,3110540,582628,554113,28515
2023,1,3110539,280123,255085,25038
2023,1,3110538,373653,364928,8725
2023,1,3110537,472744,425407,47337
2023,1,3110536,114815,100646,14169
2023,1,3110535,1058898,1121772,-62874
2023,1,3110534,586801,625392,-38591
2023,1,3110533,4977694,4303070,674624
2023,1,3110532,1076996,1052107,24889
2023,1,3110529,1054497,1085380,-30883
2023,1,3110528,893747,944919,-51172
2023,1,3110527,460094,548834,-88740
2023,1,3110526,132494,127018,5476
2023,1,3110525,441604,342578,99026
2023,1,3110524,147808,118661,29147
2023,1,3110523,79779,110475,-30696
2023,1,3110522,246467,210019,36448
2023,1,3110521,621546,675947,-54401
2023,1,3110520,589083,513769,75314
2023,1,3110519,1258931,1003596,255335
2023,1,3110517,180409,167797,12612
2023,1,3110515,499325,387009,112316
2023,1,3110514,746841,666617,80224
2023,1,3110513,181235,360436,-179201
2023,1,3110512,503580,531119,-27539
2023,1,3110511,926609,871787,54822
2023,1,3110510,906473,1007406,-100933
2023,1,3110509,822862,934154,-111292
2023,1,3110508,555262,503053,52209
2023,1,3110507,1650740,1447091,203649
2023,1,3110506,246997,250872,-3875
2023,1,3110505,53400,68720,-15320
2023,1,3110503,1876536,1788092,88444
2023,1,3110502,1384390,1699289,-314899
2023,1,3110501,162475,260520,-98045
2023,1,3110500,29632,183673,-154041
2023,1,3110499,2191758,2388937,-197179
2023,1,3110498,1910011,2110623,-200612
2023,1,3110496,946338,1065616,-119278
2023,1,3110495,1056862,1368189,-311327
2023,1,3110493,286471,426790,-140319
2023,1,3110491,64740,75733,-10993
2023,1,3110490,574749,599913,-25164
2023,1,3110489,428519,585565,-157046
2023,1,3110488,399038,518635,-119597
2023,1,3110487,162161,119574,42587
2023,1,3110486,621929,578309,43620
2023,1,3110485,490292,572338,-82046
2023,1,3110484,1676244,1750765,-74521
2023,1,3110483,644666,690555,-45889
2023,1,3110482,353118,313935,39183
2023,1,3110481,2952258,2530915,421343
2023,1,3110480,340410,407248,-66838
2023,1,3110479,1092305,1217422,-125117
2023,1,3110478,322595,455680,-133085
2023,1,3110477,367625,368966,-1341
2023,1,3110476,146255,138349,7906
2023,1,3110475,649574,704801,-55227
2023,1,3110474,956119,1062319,-106200
2023,1,3110473,1758314,1851246,-92932
2023,1,3110472,1605591,1170450,435141
2023,1,3110471,1533077,1587850,-54773
2023,1,3110470,616886,646116,-29230
2023,1,3110469,1694881,1655192,39689
2023,1,3110468,3340491,3615451,-274960
2023,1,3110467,595118,987747,-392629
2023,1,3110466,982101,1077052,-94951
2023,1,3110465,1468015,1308600,159415
2023,1,3110464,477410,501546,-24136
2023,1,3110463,639069,571429,67640
2023,1,3110462,666564,1094456,-427892
2023,1,3110461,238654,226904,11750
2023,1,3110460,1644617,1735294,-90677
2023,1,3110459,938395,959774,-21379
2023,1,3110458,932333,1187446,-255113
2023,1,3110457,812715,777000,35715
2023,1,3110456,1582159,1572831,9328
2023,1,3110455,1618989,1656388,-37399
2023,1,3110454,1277968,1339365,-61397
2023,1,3110453,1816400,1913843,-97443
2023,1,3110452,724407,958076,-233669
2023,1,3110451,1109701,1424409,-314708
2023,1,3110450,1735181,1952684,-217503
2023,1,3110449,955981,978730,-22749
2023,1,3110448,447760,639549,-191789
2023,1,3110447,515165,545165,-30000
2023,1,3110446,175560,304581,-129021
2023,1,3110444,263598,105194,158404
2023,1,3110443,80395,88378,-7983
2023,1,3110442,120101,162981,-42880
2023,1,3110441,654359,671089,-16730
2023,1,3110440,346641,387368,-40727
2023,1,3110439,1104159,1216559,-112400
2023,1,3110438,1450622,1548050,-97428
2023,1,3110437,1480530,1488807,-8277
2023,1,3110436,499881,536269,-36388
2023,1,3110435,104460,97642,6818
2023,1,3110434,514440,482044,32396
2023,1,3110433,1351637,1362916,-11279
2023,1,3110432,430538,352481,78057
2023,1,3110431,511290,465001,46289
2023,1,3110429,2098764,2069962,28802
2023,1,3110428,3798145,4247784,-449639
2023,1,3110427,107695,107648,47
2023,1,3110426,1753865,1843692,-89827
2023,1,3110425,683549,667577,15972
2023,1,3110424,2423248,2821641,-398393
2023,1,3110423,306768,309199,-2431
2023,1,3110422,896467,919952,-23485
2023,1,3110421,363850,349411,14439
2023,1,3110420,476196,615639,-139443
2023,1,3110419,885623,855186,30437
2023,1,3110418,787331,657870,129461
2023,1,3110417,402794,449254,-46460
2023,1,3110416,910055,945823,-35768
2023,1,3110415,1998147,2096186,-98039
2023,1,3110413,95069,115052,-19983
2023,1,3110412,147384,175107,-27723
2023,1,3110411,534823,546205,-11382
2023,1,3110410,696485,750572,-54087
2023,1,3110409,606860,737887,-131027
2023,1,3110408,404992,417037,-12045
2023,1,3110407,1063845,901780,162065
2023,1,3110406,206872,212767,-5895
2023,1,3110405,1515852,1516309,-457
2023,1,3110404,3460395,3382762,77633
2023,1,3110403,1322281,1711165,-388884
2023,1,3110402,741768,732042,9726
2023,1,3110401,172401,186246,-13845
2023,1,3110400,1291959,1291778,181
2023,1,3110399,1890445,1907453,-17008
2023,1,3110398,843729,890803,-47074
2023,1,3110397,1679980,1758144,-78164
2023,1,3110396,915023,1059738,-144715
2023,1,3110395,317667,288812,28855
2023,1,3110394,1293201,1132383,160818
2023,1,3110393,39356,63792,-24436
2023,1,3110392,102240,160532,-58292
2023,1,3110391,531239,567235,-35996
2023,1,3110390,556972,516727,40245
2023,1,3110389,416429,397236,19193
2023,1,3110388,841363,688949,152414
2023,1,3110387,1593035,1732082,-139047
2023,1,3110383,71844,115058,-43214
2023,1,3110382,549281,615167,-65886
2023,1,3110381,426309,439479,-13170
2023,1,3110380,688174,746049,-57875
2023,1,3110379,157164,158889,-1725
2023,1,3110378,766778,867314,-100536
2023,1,3110377,796511,680253,116258
2023,1,3110376,3040662,3312414,-271752
2023,1,3110375,662714,658301,4413
2023,1,3110374,2668108,2570952,97156
2023,1,3110373,1252284,1302305,-50021
2023,1,3110372,1636273,1773601,-137328
2023,1,3110371,725490,710555,14935
2023,1,3110370,1315275,1315393,-118
2023,1,3110369,1371701,1158093,213608
2023,1,3110368,2827392,2715449,111943
2023,1,3110367,1524513,1440148,84365
2023,1,3110366,630239,635288,-5049
2023,1,3110365,1825496,1768860,56636
2023,1,3110364,1521294,1470955,50339
2023,1,3110363,248292,304623,-56331
2023,1,3110362,899528,908882,-9354
2023,1,3110361,1210732,959613,251119
2023,1,3110360,1185825,1340927,-155102
2023,1,3110359,1045737,1039581,6156
2023,1,3110358,966698,995883,-29185
2023,1,3110357,1034177,1049211,-15034
2023,1,3110356,948705,1141481,-192776
2023,1,3110355,1789146,1386520,402626
2023,1,3110354,65170,85000,-19830
2023,1,3110353,762574,801653,-39079
2023,1,3110352,1651205,1656793,-5588
2023,1,3110351,663467,840115,-176648
2023,1,3110350,543539,538166,5373
2023,1,3110349,640750,653527,-12777
2023,1,3110348,2171883,2171905,-22
2023,1,3110346,907409,603356,304053
2023,1,3110345,703570,715262,-11692
2023,1,3110344,313536,336941,-23405
2023,1,3110343,862117,913713,-51596
2023,1,3110342,1011152,1032120,-20968
2023,1,3110341,215038,218853,-3815
2023,1,3110340,354808,322215,32593
2023,1,3110337,460489,501500,-41011
2023,1,3110336,369112,339367,29745
2023,1,3110335,1293526,1377519,-83993
2023,1,3110334,2279088,1721872,557216
2023,1,3110333,650511,736170,-85659
2023,1,3110332,279830,215805,64025
2023,1,3110331,1148830,1175654,-26824
2023,1,3110330,877792,933854,-56062
2023,1,3110329,622964,424152,198812
2023,1,3110328,1052596,1059139,-6543
2023,1,3110327,938792,883823,54969
2023,1,3110326,460385,524046,-63661
2023,1,3110325,1066959,1064092,2867
2023,1,3110323,1417982,1573688,-155706
2023,1,3110322,781778,800627,-18849
2023,1,3110320,191673,188702,2971
2023,1,3110319,1188088,1140475,47613
2023,1,3110318,1157757,1145888,11869
2023,1,3110317,731559,636654,94905
2023,1,3110316,2971881,2927134,44747
2023,1,3110315,1629846,1611567,18279
2023,1,3110314,755351,714432,40919
2023,1,3110313,1616161,1220435,395726
2023,1,3110312,472381,514001,-41620
2023,1,3110310,38898,38404,494
2023,1,3110309,388219,369629,18590
2023,1,3110308,1018719,939360,79359
2023,1,3110307,734157,734175,-18
2023,1,3110306,193184,101979,91205
2023,1,3110305,1968374,1910246,58128
2023,1,3110304,1025547,887393,138154
2023,1,3110303,1286306,1306137,-19831
2023,1,3110302,296417,249692,46725
2023,1,3110301,1576388,1550414,25974
2023,1,3110300,2815721,2919560,-103839
2023,1,3110299,1916857,1959601,-42744
2023,1,3110298,314544,363757,-49213
2023,1,3110297,2398939,2064839,334100
2023,1,3110296,940042,981970,-41928
2023,1,3110295,932469,938742,-6273
2023,1,3110294,1560779,1632401,-71622
2023,1,3110293,1474481,1522164,-47683
2023,1,3110292,308291,308564,-273
2023,1,3110291,2131746,2161113,-29367
2023,1,3110290,199678,214088,-14410
2023,1,3110289,1383635,1411876,-28241
2023,1,3110288,278862,321410,-42548
2023,1,3110287,236159,213108,23051
2023,1,3110286,710990,670661,40329
2023,1,3110285,148088,126816,21272
2023,1,3110284,94563,96917,-2354
2023,1,3110283,138219,148424,-10205
2023,1,3110282,39276,38033,1243
2023,1,3110281,68428,78674,-10246
2023,1,3110280,269440,280837,-11397
2023,1,3110278,829301,837888,-8587
2023,1,3110277,880283,1212133,-331850
2023,1,3110276,47612,46668,944
2023,1,3110275,564327,435785,128542
2023,1,3110274,1278572,1309948,-31376
2023,1,3110273,784482,799232,-14750
2023,1,3110272,1305935,1309739,-3804
2023,1,3110271,50513,45877,4636
2023,1,3110270,311856,463660,-151804
2023,1,3110269,475388,463239,12149
2023,1,3110268,562800,531690,31110
2023,1,3110267,1346998,1471041,-124043
2023,1,3110266,1653740,1679768,-26028
2023,1,3110265,509405,488125,21280
2023,1,3110264,2935288,3149906,-214618
2023,1,3110263,1341566,1376226,-34660
2023,1,3110262,1938781,1801314,137467
2023,1,3110261,1537109,1557066,-19957
2023,1,3110260,1435651,1580559,-144908
2023,1,3110259,1625312,1446392,178920
2023,1,3110258,768206,670941,97265
2023,1,3110257,2117029,1919365,197664
2023,1,3110256,1682453,1706158,-23705
2023,1,3110255,2078027,2064568,13459
2023,1,3110254,3238996,3744106,-505110
2023,1,3110253,848485,817253,31232
2023,1,3110252,1042499,913907,128592
2023,1,3110251,648154,743828,-95674
2023,1,3110250,501680,463286,38394
2023,1,3110249,1814282,2181031,-366749
2023,1,3110248,549396,581919,-32523
2023,1,3110247,2257877,2255983,1894
2023,1,3110246,1440832,1478768,-37936
2023,1,3110245,551946,544282,7664
2023,1,3110244,1241877,891278,350599
2023,1,3110243,649559,1029903,-380344
2023,1,3110242,529451,772554,-243103
2023,1,3110241,1044102,1177077,-132975
2023,1,3110240,696359,721470,-25111
2023,1,3110238,91565,92557,-992
2023,1,3110237,965536,1040998,-75462
2023,1,3110236,1935970,2056319,-120349
2023,1,3110234,339743,303753,35990
2023,1,3110233,1245190,1223305,21885
2023,1,3110232,857234,885771,-28537
2023,1,3110230,989114,1054551,-65437
2023,1,3110229,1848388,1843810,4578
2023,1,3110228,1592797,1633992,-41195
2023,1,3110227,505679,633118,-127439
2023,1,3110226,2802678,2563633,239045
2023,1,3110225,242238,392207,-149969
2023,1,3110224,707137,581274,125863
2023,1,3110221,290365,272958,17407
2023,1,3110220,1199690,1106471,93219
2023,1,3110219,1481759,1674167,-192408
2023,1,3110218,1336198,1299626,36572
2023,1,3110217,602645,645947,-43302
2023,1,3110216,338115,355654,-17539
2023,1,3110215,713735,714400,-665
2023,1,3110214,1532722,1412484,120238
2023,1,3110213,536705,513551,23154
2023,1,3110212,1042561,1093255,-50694
2023,1,3110211,2232864,2410613,-177749
2023,1,3110210,2203170,2248291,-45121
2023,1,3110209,328130,348032,-19902
2023,1,3110208,389173,371206,17967
2023,1,3110207,531068,576119,-45051
2023,1,3110206,1276553,1584961,-308408
2023,1,3110205,2169400,1891890,277510
2023,1,3110204,1241020,1509260,-268240
2023,1,3110203,812807,671987,140820
2023,1,3110201,124479,148039,-23560
2023,1,3110200,391202,451320,-60118
2023,1,3110199,247174,446848,-199674
2023,1,3110197,272399,297386,-24987
2023,1,3110195,1531482,1505207,26275
2023,1,3110194,336244,569808,-233564
2023,1,3110193,811968,748087,63881
2023,1,3110191,1744833,1081274,663559
2023,1,3110190,971664,1374868,-403204
2023,1,3110189,980517,1024500,-43983
2023,1,3110188,838967,957277,-118310
2023,1,3110187,2584517,2854152,-269635
2023,1,3110186,156342,147066,9276
2023,1,3110185,699158,758141,-58983
2023,1,3110184,298917,275281,23636
2023,1,3110183,642606,468997,173609
2023,1,3110182,943083,805957,137126
2023,1,3110181,1325251,1251977,73274
2023,1,3110180,240100,237413,2687
2023,1,3110179,494203,535492,-41289
2023,1,3110178,317418,336858,-19440
2023,1,3110177,138962,95867,43095
2023,1,3110176,1276150,1621398,-345248
2023,1,3110175,1231172,1226808,4364
2023,1,3110174,833187,933735,-100548
2023,1,3110173,414214,403837,10377
2023,1,3110172,989389,798611,190778
2023,1,3110171,336936,324081,12855
2023,1,3110170,2612574,3125304,-512730
2023,1,3110169,553892,602704,-48812
2023,1,3110168,470074,459439,10635
2023,1,3110167,1745856,1872530,-126674
2023,1,3110166,1988213,2101495,-113282
2023,1,3110165,720337,748076,-27739
2023,1,3110164,439750,433935,5815
2023,1,3110163,564058,864908,-300850
2023,1,3110162,487315,527974,-40659
2023,1,3110161,701342,993551,-292209
2023,1,3110160,542335,758868,-216533
2023,1,3110159,3726205,3413021,313184
2023,1,3110158,2959590,2708025,251565
2023,1,3110157,1427082,1314215,112867
2023,1,3110156,1052911,1094840,-41929
2023,1,3110155,892202,880281,11921
2023,1,3110154,1644019,2136260,-492241
2023,1,3110153,312743,296376,16367
2023,1,3110152,270120,272470,-2350
2023,1,3110151,1372010,1437198,-65188
2023,1,3110150,1907508,1934707,-27199
2023,1,3110149,249775,234129,15646
2023,1,3110148,570390,513402,56988
2023,1,3110147,929460,933903,-4443
2023,1,3110146,1412853,1676295,-263442
2023,1,3110144,400065,382894,17171
2023,1,3110142,2009436,2003801,5635
2023,1,3110141,1840722,1906744,-66022
2023,1,3110140,2352704,2162631,190073
2023,1,3110139,2062618,2099296,-36678
2023,1,3110138,1003130,1312425,-309295
2023,1,3110137,1548398,1413716,134682
2023,1,3110136,1195368,1237660,-42292
2023,1,3110135,303398,217767,85631
2023,1,3110134,1437923,1485664,-47741
2023,1,3110133,373950,449734,-75784
2023,1,3110132,547163,622662,-75499
2023,1,3110131,828038,744737,83301
2023,1,3110130,612739,503785,108954
2023,1,3110129,189811,236411,-46600
2023,1,3110128,1254083,1348298,-94215
2023,1,3110127,189107,152035,37072
2023,1,3110126,345857,314990,30867
2023,1,3110125,968235,934025,34210
2023,1,3110124,251469,481584,-230115
2023,1,3110123,860587,840282,20305
2023,1,3110122,288931,318777,-29846
2023,1,3110121,199086,139177,59909
2023,1,3110120,331004,395902,-64898
2023,1,3110118,926787,609148,317639
2023,1,3110117,490671,514371,-23700
2023,1,3110116,615502,684592,-69090
2023,1,3110115,751316,875295,-123979
2023,1,3110114,384813,464219,-79406
2023,1,3110113,156755,167785,-11030
2023,1,3110112,772394,906367,-133973
2023,1,3110110,1006243,1073961,-67718
2023,1,3110109,369738,306305,63433
2023,1,3110107,63297,113240,-49943
2023,1,3110105,832347,896634,-64287
2023,1,3110104,1203500,1286675,-83175
2023,1,3110103,294246,251709,42537
2023,1,3110102,620756,623105,-2349
2023,1,3110099,252089,340566,-88477
2023,1,3110098,84840,85153,-313
2023,1,3110096,252072,241705,10367
2023,1,3110095,470141,480075,-9934
2023,1,3110093,2819227,2553981,265246
2023,1,3110092,730138,697812,32326
2023,1,3110090,630023,653577,-23554
2023,1,3110089,482565,530103,-47538
2023,1,3110088,386552,407735,-21183
2023,1,3110087,235269,259423,-24154
2023,1,3110085,1325947,1314155,11792
2023,1,3110084,1001229,929060,72169
2023,1,3110083,89032,95672,-6640
2023,1,3110082,357842,327608,30234
2023,1,3110081,1557858,1872990,-315132
2023,1,3110080,1473430,1593111,-119681
2023,1,3110079,2111219,2202005,-90786
2023,1,3110078,116925,119148,-2223
2023,1,3110077,622406,541898,80508
2023,1,3110075,920273,854739,65534
2023,1,3110074,777866,773501,4365
2023,1,3110073,258565,116073,142492
2023,1,3110071,52604,40526,12078
2023,1,3110070,48291,59147,-10856
2023,1,3110069,2286989,2365920,-78931
2023,1,3110068,1740971,1627882,113089
2023,1,3110067,2418659,2526097,-107438
2023,1,3110066,1353866,1341746,12120
2023,1,3110065,56207,57193,-986
2023,1,3110064,1395731,1569086,-173355
2023,1,3110063,779241,916101,-136860
2023,1,3110062,804507,849119,-44612
2023,1,3110061,1338929,1316387,22542
2023,1,3110060,619096,615859,3237
2023,1,3110059,560428,879372,-318944
2023,1,3110058,1509069,1487396,21673
2023,1,3110057,738118,852090,-113972
2023,1,3110056,1795298,2002257,-206959
2023,1,3110055,502770,504882,-2112
2023,1,3110054,1087043,1023915,63128
2023,1,3110053,798065,1114946,-316881
2023,1,3110052,642105,565644,76461
2023,1,3110051,969364,888344,81020
2023,1,3110050,449109,401341,47768
2023,1,3110049,763781,613576,150205
2023,1,3110048,889308,843451,45857
2023,1,3110047,590942,582715,8227
2023,1,3110045,662564,614926,47638
2023,1,3110043,766110,740893,25217
2023,1,3110042,187817,166938,20879
2023,1,3110041,313208,272099,41109
2023,1,3110040,168877,170377,-1500
2023,1,3110039,86703,89617,-2914
2023,1,3110037,884421,891719,-7298
2023,1,3110036,345836,395618,-49782
2023,1,3110035,1382387,1265171,117216
2023,1,3110033,694403,709911,-15508
2023,1,3110031,65044,62927,2117
2023,1,3110030,146777,141066,5711
2023,1,3110029,3381636,3242822,138814
2023,1,3110028,2683301,2624455,58846
2023,1,3110027,367406,371364,-3958
2023,1,3110025,290561,211926,78635
2023,1,3110024,324535,316429,8106
2023,1,3110023,365909,369722,-3813
2023,1,3110022,541683,557111,-15428
2023,1,3110021,1443781,1315429,128352
2023,1,3110020,1856468,1829358,27110
2023,1,3110018,471185,436602,34583
2023,1,3110017,448804,439142,9662
2023,1,3110016,39448,32611,6837
2023,1,3110014,60753,52469,8284
2023,1,3110012,615093,571544,43549
2023,1,3110010,133922,176332,-42410
2023,1,3110009,167144,177855,-10711
2023,1,3110008,1277779,1242028,35751
2023,1,3110007,905738,917103,-11365
2023,1,3110006,8336,6845,1491
2023,1,3110005,114445,125167,-10722
2023,1,3110004,642485,525499,116986
2023,1,3110003,543590,729450,-185860
2023,1,3110002,560130,529340,30790
2023,1,3110001,165477,128326,37151
